//MAP CONVERTED BY dmm2tgm.py THIS HEADER COMMENT PREVENTS RECONVERSION, DO NOT REMOVE
"a" = (
/obj/structure/cable,
/obj/effect/turf_decal/tile/red/half/contrasted{
	dir = 8
	},
/turf/open/floor/iron/dark,
/area/station/security/lockers)

(1,1,1) = {"
a
"}
