//MAP CONVERTED BY dmm2tgm.py THIS HEADER COMMENT PREVENTS RECONVERSION, DO NOT REMOVE
"ap" = (
/obj/effect/decal/syndie_logo{
	icon_state = "logo13"
	},
/turf/open/floor/mineral/plastitanium,
/area/shuttle/syndicate/bridge)
"aO" = (
/obj/item/storage/toolbox/syndicate,
/obj/item/screwdriver{
	pixel_y = 9
	},
/obj/structure/table/reinforced/plastitaniumglass,
/obj/machinery/light/small/directional/south,
/turf/open/floor/iron/dark,
/area/shuttle/syndicate/engineering)
"bd" = (
/obj/structure/chair/comfy/shuttle/tactical{
	dir = 8
	},
/obj/effect/turf_decal/stripes/line{
	dir = 9
	},
/obj/item/radio/intercom/directional/north,
/turf/open/floor/mineral/plastitanium,
/area/shuttle/syndicate/bridge)
"bi" = (
/obj/effect/turf_decal/tile/blue/fourcorners,
/obj/machinery/light/floor,
/mob/living/basic/bot/medbot/nukie,
/turf/open/floor/iron/white,
/area/shuttle/syndicate/medical)
"bP" = (
/obj/effect/spawner/structure/window/reinforced/plasma/plastitanium,
/obj/machinery/door/poddoor/shutters{
	id = "infiltrator_window_shutters";
	name = "Blast Shutters";
	dir = 4
	},
/turf/open/floor/plating,
/area/shuttle/syndicate/hallway)
"cn" = (
/obj/effect/turf_decal/siding/thinplating_new/dark,
/turf/open/floor/mineral/plastitanium/red,
/area/shuttle/syndicate/hallway)
"cD" = (
/turf/closed/wall/r_wall/plastitanium/syndicate,
/area/shuttle/syndicate/hallway)
"cK" = (
/obj/effect/spawner/structure/window/reinforced/plasma/plastitanium,
/obj/machinery/door/poddoor/shutters{
	id = "infiltrator_window_shutters";
	name = "Blast Shutters";
	dir = 8
	},
/turf/open/floor/plating,
/area/shuttle/syndicate/hallway)
"do" = (
/obj/structure/table/reinforced/plastitaniumglass,
/obj/item/stack/sheet/iron/fifty{
	pixel_x = -3;
	pixel_y = 6
	},
/obj/item/stack/sheet/glass/fifty{
	pixel_x = 3;
	pixel_y = 6
	},
/obj/effect/turf_decal/stripes/line{
	dir = 9
	},
/obj/structure/extinguisher_cabinet/directional/east,
/turf/open/floor/mineral/plastitanium,
/area/shuttle/syndicate/hallway)
"dG" = (
/obj/machinery/door/airlock/external,
/obj/effect/mapping_helpers/airlock/cyclelink_helper_multi{
	cycle_id = "infiltrator_entrance"
	},
/obj/effect/mapping_helpers/airlock/autoname,
/obj/effect/mapping_helpers/airlock/access/all/syndicate/general,
/turf/open/floor/plating,
/area/shuttle/syndicate/airlock)
"dP" = (
/obj/structure/chair/comfy/shuttle/tactical{
	dir = 4
	},
/obj/effect/turf_decal/stripes/line{
	dir = 4
	},
/turf/open/floor/mineral/plastitanium,
/area/shuttle/syndicate/bridge)
"eO" = (
/obj/effect/decal/syndie_logo{
	icon_state = "logo11"
	},
/turf/open/floor/mineral/plastitanium,
/area/shuttle/syndicate/bridge)
"ff" = (
/obj/effect/decal/syndie_logo{
	icon_state = "logo10"
	},
/turf/open/floor/mineral/plastitanium,
/area/shuttle/syndicate/bridge)
"fs" = (
/obj/effect/turf_decal/stripes/line{
	dir = 8
	},
/turf/open/floor/iron/dark,
/area/shuttle/syndicate/airlock)
"fO" = (
/obj/effect/turf_decal/stripes/line{
	dir = 10
	},
/turf/open/floor/iron/dark,
/area/shuttle/syndicate/airlock)
"gm" = (
/obj/item/weldingtool/largetank{
	pixel_y = 3
	},
/obj/item/multitool,
/obj/item/wrench,
/obj/item/crowbar/red,
/obj/structure/table/reinforced/plastitaniumglass,
/turf/open/floor/iron/dark,
/area/shuttle/syndicate/engineering)
"go" = (
/obj/machinery/porta_turret/syndicate/shuttle{
	dir = 5
	},
/turf/closed/wall/r_wall/plastitanium/syndicate,
/area/shuttle/syndicate/bridge)
"gw" = (
/obj/machinery/recharge_station,
/obj/effect/turf_decal/box,
/turf/open/floor/iron/dark,
/area/shuttle/syndicate/engineering)
"gx" = (
/obj/machinery/power/shuttle_engine/huge,
/turf/template_noop,
/area/shuttle/syndicate/medical)
"hq" = (
/obj/effect/turf_decal/stripes/line{
	dir = 4
	},
/turf/open/floor/iron/dark,
/area/shuttle/syndicate/airlock)
"hs" = (
/obj/effect/decal/syndie_logo{
	icon_state = "logo9"
	},
/turf/open/floor/mineral/plastitanium,
/area/shuttle/syndicate/bridge)
"hy" = (
/obj/machinery/door/window/survival_pod/left/directional/south,
/obj/effect/turf_decal/box,
/obj/machinery/nuclearbomb/syndicate/bananium{
	anchored = 1
	},
/turf/open/floor/mineral/plastitanium,
/area/shuttle/syndicate/hallway)
"hA" = (
/turf/open/floor/mineral/plastitanium/red,
/area/shuttle/syndicate/hallway)
"hG" = (
/turf/closed/wall/r_wall/plastitanium/syndicate,
/area/shuttle/syndicate/bridge)
"iq" = (
/obj/effect/decal/syndie_logo{
	icon_state = "logo12"
	},
/turf/open/floor/mineral/plastitanium,
/area/shuttle/syndicate/bridge)
"iw" = (
/obj/machinery/suit_storage_unit/syndicate,
/obj/effect/turf_decal/stripes/line{
	dir = 10
	},
/turf/open/floor/mineral/plastitanium,
/area/shuttle/syndicate/hallway)
"iH" = (
/obj/machinery/porta_turret/syndicate/shuttle{
	dir = 5
	},
/turf/closed/wall/r_wall/plastitanium/syndicate,
/area/shuttle/syndicate/engineering)
"iK" = (
/obj/machinery/cell_charger,
/obj/item/stock_parts/power_store/cell/high{
	pixel_x = -3;
	pixel_y = 3
	},
/obj/item/stock_parts/power_store/cell/high,
/obj/structure/table/reinforced/plastitaniumglass,
/turf/open/floor/iron/dark,
/area/shuttle/syndicate/engineering)
"jz" = (
/obj/structure/reagent_dispensers/fueltank,
/turf/open/floor/iron/dark,
/area/shuttle/syndicate/engineering)
"jF" = (
/obj/structure/tank_dispenser/oxygen,
/obj/effect/turf_decal/stripes/line{
	dir = 6
	},
/turf/open/floor/mineral/plastitanium,
/area/shuttle/syndicate/hallway)
"jP" = (
/obj/effect/decal/syndie_logo{
	icon_state = "logo16"
	},
/obj/item/banner/syndicate,
/turf/open/floor/mineral/plastitanium,
/area/shuttle/syndicate/bridge)
"jQ" = (
/turf/open/floor/mineral/plastitanium,
/area/shuttle/syndicate/bridge)
"jX" = (
/obj/item/sbeacondrop/bomb{
	pixel_y = 5
	},
/obj/item/sbeacondrop/bomb,
/obj/structure/table/reinforced/plastitaniumglass,
/obj/effect/turf_decal/stripes/line{
	dir = 6
	},
/turf/open/floor/mineral/plastitanium,
/area/shuttle/syndicate/hallway)
"ke" = (
/obj/structure/lattice,
/turf/template_noop,
/area/shuttle/syndicate/medical)
"ko" = (
/obj/machinery/light/small/directional/south,
/turf/open/floor/mineral/plastitanium/red,
/area/shuttle/syndicate/hallway)
"kp" = (
/obj/machinery/porta_turret/syndicate/shuttle{
	dir = 9
	},
/turf/closed/wall/r_wall/plastitanium/syndicate,
/area/shuttle/syndicate/hallway)
"ks" = (
/obj/machinery/computer/camera_advanced/syndie,
/obj/effect/decal/syndie_logo{
	icon_state = "logo4"
	},
/turf/open/floor/mineral/plastitanium,
/area/shuttle/syndicate/bridge)
"kB" = (
/obj/effect/turf_decal/stripes/line{
	dir = 5
	},
/turf/open/floor/iron/dark,
/area/shuttle/syndicate/airlock)
"kI" = (
/obj/machinery/porta_turret/syndicate/shuttle{
	dir = 5
	},
/turf/closed/wall/r_wall/plastitanium/syndicate,
/area/shuttle/syndicate/hallway)
"mR" = (
/turf/template_noop,
/area/template_noop)
"nj" = (
/obj/machinery/power/shuttle_engine/heater,
/obj/structure/window/reinforced/tinted/spawner/directional/north,
/obj/effect/turf_decal/stripes/line,
/turf/open/floor/plating/airless,
/area/shuttle/syndicate/medical)
"nK" = (
/obj/machinery/computer/shuttle/syndicate,
/obj/effect/decal/syndie_logo{
	icon_state = "logo3"
	},
/turf/open/floor/mineral/plastitanium,
/area/shuttle/syndicate/bridge)
"nL" = (
/obj/machinery/recharge_station,
/obj/effect/turf_decal/box,
/obj/structure/railing{
	dir = 4
	},
/turf/open/floor/iron/dark,
/area/shuttle/syndicate/engineering)
"oP" = (
/turf/template_noop,
/area/shuttle/syndicate/engineering)
"oV" = (
/obj/structure/railing{
	dir = 1
	},
/obj/effect/turf_decal/caution,
/obj/machinery/light/directional/east,
/obj/item/radio/intercom/directional/east,
/turf/open/floor/iron/dark,
/area/shuttle/syndicate/engineering)
"pa" = (
/obj/machinery/button/door/directional/east{
	id = "infiltrator_shuttle_entrance";
	req_access = list("syndicate");
	name = "Shuttle Blast Door Control"
	},
/obj/structure/fans/tiny,
/obj/machinery/door/airlock/external,
/obj/machinery/door/poddoor{
	id = "infiltrator_shuttle_entrance";
	name = "Outer Blast Door"
	},
/obj/effect/mapping_helpers/airlock/cyclelink_helper_multi{
	cycle_id = "infiltrator_entrance"
	},
/obj/effect/mapping_helpers/airlock/autoname,
/obj/effect/mapping_helpers/airlock/access/all/syndicate/general,
/turf/open/floor/plating,
/area/shuttle/syndicate/airlock)
"pk" = (
/obj/effect/turf_decal/stripes/line{
	dir = 6
	},
/obj/structure/sign/warning/vacuum/directional/south,
/turf/open/floor/iron/dark,
/area/shuttle/syndicate/airlock)
"qn" = (
/turf/closed/wall/r_wall/plastitanium/syndicate/nodiagonal,
/area/shuttle/syndicate/bridge)
"qD" = (
/obj/structure/extinguisher_cabinet/directional/south,
/turf/open/floor/catwalk_floor/iron_dark,
/area/shuttle/syndicate/engineering)
"rO" = (
/obj/structure/table/reinforced/plastitaniumglass,
/obj/machinery/button/door{
	id = "infiltrator_window_shutters";
	name = "Window Shutters Control"
	},
/turf/open/floor/mineral/plastitanium/red,
/area/shuttle/syndicate/bridge)
"rU" = (
/obj/structure/chair/comfy/shuttle/tactical{
	dir = 1
	},
/obj/effect/decal/syndie_logo{
	icon_state = "logo6"
	},
/turf/open/floor/mineral/plastitanium,
/area/shuttle/syndicate/bridge)
"sq" = (
/obj/machinery/computer/crew/syndie,
/obj/effect/decal/syndie_logo,
/turf/open/floor/mineral/plastitanium,
/area/shuttle/syndicate/bridge)
"st" = (
/obj/structure/lattice/catwalk,
/obj/structure/marker_beacon/burgundy,
/turf/template_noop,
/area/shuttle/syndicate/airlock)
"sR" = (
/obj/structure/table/reinforced,
/obj/item/reagent_containers/cup/beaker/large{
	pixel_x = 5;
	pixel_y = 5
	},
/obj/item/reagent_containers/cup/beaker,
/obj/item/reagent_containers/dropper{
	pixel_x = -4;
	pixel_y = -8
	},
/turf/open/floor/iron/white,
/area/shuttle/syndicate/medical)
"tb" = (
/obj/structure/closet/syndicate/nuclear,
/obj/item/crowbar/red,
/obj/effect/turf_decal/bot_red,
/turf/open/floor/mineral/plastitanium,
/area/shuttle/syndicate/hallway)
"tx" = (
/obj/machinery/status_display/evac/directional/north,
/turf/open/floor/mineral/plastitanium/red,
/area/shuttle/syndicate/hallway)
"uo" = (
/turf/open/floor/catwalk_floor/iron_dark,
/area/shuttle/syndicate/engineering)
"uM" = (
/obj/machinery/computer/camera_advanced/shuttle_docker/syndicate,
/obj/effect/decal/syndie_logo{
	icon_state = "logo2"
	},
/turf/open/floor/mineral/plastitanium,
/area/shuttle/syndicate/bridge)
"vd" = (
/obj/effect/spawner/structure/window/reinforced/plasma/plastitanium,
/turf/open/floor/plating,
/area/shuttle/syndicate/hallway)
"vs" = (
/obj/effect/spawner/structure/window/reinforced/plasma/plastitanium,
/obj/machinery/door/poddoor/shutters{
	id = "infiltrator_window_shutters";
	name = "Blast Shutters"
	},
/turf/open/floor/plating,
/area/shuttle/syndicate/bridge)
"wn" = (
/obj/item/assembly/prox_sensor{
	pixel_x = -8;
	pixel_y = 4
	},
/obj/item/assembly/prox_sensor{
	pixel_x = -8;
	pixel_y = 4
	},
/obj/item/stack/cable_coil,
/obj/item/stack/cable_coil,
/obj/item/assembly/voice{
	pixel_y = 3
	},
/obj/structure/table/reinforced/plastitaniumglass,
/turf/open/floor/iron/dark,
/area/shuttle/syndicate/engineering)
"wt" = (
/obj/effect/mapping_helpers/airlock/autoname,
/obj/machinery/door/airlock/hatch,
/obj/effect/mapping_helpers/airlock/access/all/syndicate/general,
/turf/open/floor/iron/dark,
/area/shuttle/syndicate/bridge)
"wG" = (
/obj/machinery/mech_bay_recharge_port{
	dir = 1
	},
/obj/effect/turf_decal/stripes/line{
	dir = 10
	},
/turf/open/floor/mineral/plastitanium,
/area/shuttle/syndicate/hallway)
"xb" = (
/obj/machinery/door/window/survival_pod/left/directional/south,
/obj/structure/table/reinforced/plastitaniumglass,
/obj/item/book/manual/nuclear,
/turf/open/floor/mineral/plastitanium,
/area/shuttle/syndicate/hallway)
"xi" = (
/turf/template_noop,
/area/shuttle/syndicate/medical)
"yI" = (
/obj/effect/mapping_helpers/airlock/autoname,
/obj/machinery/door/airlock/hatch,
/obj/effect/mapping_helpers/airlock/access/all/syndicate/general,
/turf/open/floor/iron/dark,
/area/shuttle/syndicate/hallway)
"yO" = (
/obj/machinery/computer/operating{
	dir = 1
	},
/turf/open/floor/iron/white,
/area/shuttle/syndicate/medical)
"yT" = (
/obj/effect/turf_decal/siding/thinplating_new/dark{
	dir = 8
	},
/obj/machinery/light/directional/south,
/turf/open/floor/mineral/plastitanium/red,
/area/shuttle/syndicate/hallway)
"yU" = (
/obj/machinery/portable_atmospherics/canister/oxygen,
/obj/effect/turf_decal/stripes/line{
	dir = 10
	},
/turf/open/floor/plating,
/area/shuttle/syndicate/engineering)
"zg" = (
/obj/effect/turf_decal/siding/thinplating_new/dark,
/obj/structure/sign/departments/engineering/directional/east,
/turf/open/floor/mineral/plastitanium/red,
/area/shuttle/syndicate/hallway)
"zh" = (
/obj/effect/decal/syndie_logo{
	icon_state = "logo14"
	},
/turf/open/floor/mineral/plastitanium,
/area/shuttle/syndicate/bridge)
"zU" = (
/obj/item/radio/intercom/directional/west,
/turf/open/floor/mineral/plastitanium/red,
/area/shuttle/syndicate/hallway)
"zV" = (
/obj/structure/tank_dispenser/oxygen,
/obj/effect/turf_decal/stripes/line{
	dir = 10
	},
/turf/open/floor/mineral/plastitanium,
/area/shuttle/syndicate/hallway)
"Ar" = (
/obj/machinery/computer/mech_bay_power_console{
	dir = 8
	},
/obj/effect/turf_decal/stripes/line{
	dir = 8
	},
/turf/open/floor/mineral/plastitanium,
/area/shuttle/syndicate/hallway)
"AY" = (
/obj/machinery/porta_turret/syndicate/shuttle{
	dir = 9
	},
/turf/closed/wall/r_wall/plastitanium/syndicate,
/area/shuttle/syndicate/bridge)
"Bs" = (
/obj/effect/turf_decal/stripes/corner{
	dir = 1
	},
/turf/open/floor/iron/dark,
/area/shuttle/syndicate/airlock)
"Dm" = (
/turf/closed/wall/r_wall/plastitanium/syndicate/nodiagonal,
/area/shuttle/syndicate/hallway)
"Do" = (
/turf/closed/wall/r_wall/plastitanium/syndicate,
/area/shuttle/syndicate/engineering)
"DD" = (
/obj/machinery/light/directional/south,
/turf/open/floor/mineral/plastitanium/red,
/area/shuttle/syndicate/bridge)
"DF" = (
/turf/open/floor/plating/airless,
/area/shuttle/syndicate/medical)
"DU" = (
/obj/structure/lattice/catwalk,
/obj/structure/marker_beacon/burgundy,
/turf/template_noop,
/area/shuttle/syndicate/hallway)
"DV" = (
/turf/closed/wall/r_wall/plastitanium/syndicate/nodiagonal,
/area/shuttle/syndicate/airlock)
"Ex" = (
/obj/structure/table/reinforced,
/obj/item/bodypart/arm/left/robot{
	pixel_x = -4;
	pixel_y = 8
	},
/obj/item/bodypart/arm/right/robot{
	pixel_x = -10;
	pixel_y = 9
	},
/obj/item/stack/medical/ointment,
/obj/item/stack/medical/wrap/gauze,
/obj/item/stack/medical/bruise_pack,
/obj/item/healthanalyzer,
/turf/open/floor/iron/white,
/area/shuttle/syndicate/medical)
"EO" = (
/obj/effect/turf_decal/stripes/corner{
	dir = 8
	},
/turf/open/floor/iron/dark,
/area/shuttle/syndicate/airlock)
"EZ" = (
/obj/structure/chair/comfy/shuttle/tactical{
	dir = 8
	},
/obj/effect/turf_decal/stripes/line{
	dir = 8
	},
/turf/open/floor/mineral/plastitanium,
/area/shuttle/syndicate/bridge)
"Fc" = (
/obj/structure/table/reinforced/plastitaniumglass,
/obj/item/storage/fancy/donut_box,
/turf/open/floor/mineral/plastitanium/red,
/area/shuttle/syndicate/bridge)
"Ff" = (
/obj/structure/extinguisher_cabinet/directional/south,
/turf/open/floor/iron/white,
/area/shuttle/syndicate/medical)
"Fl" = (
/obj/structure/lattice,
/turf/template_noop,
/area/shuttle/syndicate/engineering)
"FJ" = (
/obj/effect/decal/syndie_logo{
	icon_state = "logo15"
	},
/turf/open/floor/mineral/plastitanium,
/area/shuttle/syndicate/bridge)
"He" = (
/turf/open/floor/plating/airless,
/area/shuttle/syndicate/engineering)
"Hm" = (
/obj/structure/bed/medical/emergency,
/obj/machinery/iv_drip,
/turf/open/floor/iron/white,
/area/shuttle/syndicate/medical)
"HA" = (
/obj/machinery/suit_storage_unit/syndicate,
/obj/effect/turf_decal/stripes/line,
/obj/machinery/light/directional/north,
/turf/open/floor/mineral/plastitanium,
/area/shuttle/syndicate/hallway)
"HC" = (
/turf/closed/wall/r_wall/plastitanium/syndicate,
/area/shuttle/syndicate/medical)
"HD" = (
/obj/machinery/portable_atmospherics/canister/oxygen,
/obj/effect/turf_decal/stripes/line{
	dir = 9
	},
/turf/open/floor/plating,
/area/shuttle/syndicate/engineering)
"Ir" = (
/obj/item/storage/box/handcuffs{
	pixel_x = 3;
	pixel_y = 3
	},
/obj/item/storage/box/zipties,
/obj/structure/table/reinforced/plastitaniumglass,
/obj/effect/turf_decal/stripes/line{
	dir = 4
	},
/turf/open/floor/mineral/plastitanium,
/area/shuttle/syndicate/hallway)
"Iv" = (
/obj/machinery/porta_turret/syndicate/shuttle{
	dir = 9
	},
/turf/closed/wall/r_wall/plastitanium/syndicate,
/area/shuttle/syndicate/medical)
"IV" = (
/obj/item/assembly/signaler{
	pixel_x = 8
	},
/obj/item/assembly/infra,
/obj/structure/table/reinforced/plastitaniumglass,
/turf/open/floor/iron/dark,
/area/shuttle/syndicate/engineering)
"Jz" = (
/obj/structure/railing/corner/end/flip{
	dir = 4
	},
/turf/open/floor/catwalk_floor/iron_dark,
/area/shuttle/syndicate/engineering)
"JZ" = (
/obj/effect/turf_decal/siding/thinplating_new/dark/corner,
/obj/item/radio/intercom/directional/north,
/turf/open/floor/mineral/plastitanium/red,
/area/shuttle/syndicate/hallway)
"Kg" = (
/obj/structure/table/reinforced,
/obj/item/storage/backpack/duffelbag/syndie/surgery,
/obj/machinery/light/directional/west,
/obj/item/radio/intercom/directional/west,
/turf/open/floor/iron/white,
/area/shuttle/syndicate/medical)
"Kh" = (
/obj/effect/turf_decal/stripes/line{
	dir = 6
	},
/turf/open/floor/iron/dark,
/area/shuttle/syndicate/airlock)
"KD" = (
/obj/effect/turf_decal/siding/thinplating_new/dark{
	dir = 4
	},
/obj/structure/sign/warning/vacuum/directional/south,
/obj/machinery/light/directional/south,
/turf/open/floor/mineral/plastitanium/red,
/area/shuttle/syndicate/hallway)
"KX" = (
/turf/open/floor/iron/dark,
/area/shuttle/syndicate/engineering)
"Lq" = (
/obj/effect/turf_decal/siding/thinplating_new/dark,
/obj/structure/sign/departments/medbay/alt/directional/west,
/turf/open/floor/mineral/plastitanium/red,
/area/shuttle/syndicate/hallway)
"Lr" = (
/obj/effect/decal/syndie_logo{
	icon_state = "logo17"
	},
/turf/open/floor/mineral/plastitanium,
/area/shuttle/syndicate/bridge)
"LB" = (
/obj/machinery/light/floor,
/obj/effect/turf_decal/stripes/line{
	dir = 9
	},
/obj/structure/sign/poster/contraband/syndicate_recruitment/directional/north,
/turf/open/floor/iron/dark,
/area/shuttle/syndicate/airlock)
"Mt" = (
/obj/structure/lattice,
/turf/template_noop,
/area/shuttle/syndicate/hallway)
"Mv" = (
/turf/open/floor/iron/white,
/area/shuttle/syndicate/medical)
"Nm" = (
/obj/machinery/porta_turret/syndicate/shuttle{
	dir = 6
	},
/turf/closed/wall/r_wall/plastitanium/syndicate,
/area/shuttle/syndicate/airlock)
"Nr" = (
/turf/closed/wall/r_wall/plastitanium/syndicate,
/area/shuttle/syndicate/airlock)
"Oc" = (
/turf/open/floor/mineral/plastitanium/red,
/area/shuttle/syndicate/bridge)
"Pt" = (
/obj/effect/decal/syndie_logo{
	icon_state = "logo19"
	},
/obj/item/banner/syndicate,
/turf/open/floor/mineral/plastitanium,
/area/shuttle/syndicate/bridge)
"PN" = (
/obj/structure/table/reinforced,
/obj/item/healthanalyzer,
/obj/item/healthanalyzer{
	pixel_y = 10
	},
/turf/open/floor/iron/white,
/area/shuttle/syndicate/medical)
"PY" = (
/obj/machinery/computer/records/security/laptop/syndie,
/obj/structure/table/reinforced/plastitaniumglass,
/obj/effect/turf_decal/stripes/line{
	dir = 5
	},
/obj/structure/extinguisher_cabinet/directional/west,
/turf/open/floor/mineral/plastitanium,
/area/shuttle/syndicate/hallway)
"QK" = (
/obj/effect/decal/syndie_logo{
	icon_state = "logo8"
	},
/turf/open/floor/mineral/plastitanium,
/area/shuttle/syndicate/bridge)
"QY" = (
/obj/item/radio/intercom/directional/east,
/turf/open/floor/mineral/plastitanium/red,
/area/shuttle/syndicate/hallway)
"Rl" = (
/obj/machinery/sleeper/syndie{
	dir = 8
	},
/turf/open/floor/iron/white,
/area/shuttle/syndicate/medical)
"RJ" = (
/obj/item/grenade/syndieminibomb{
	pixel_x = 4;
	pixel_y = 2
	},
/obj/item/grenade/syndieminibomb{
	pixel_x = -1
	},
/obj/item/grenade/c4{
	pixel_x = -6
	},
/obj/item/grenade/c4{
	pixel_x = -6
	},
/obj/item/grenade/c4{
	pixel_x = -6
	},
/obj/item/grenade/c4{
	pixel_x = -6
	},
/obj/item/grenade/c4{
	pixel_x = -6
	},
/obj/structure/table/reinforced/plastitaniumglass,
/obj/effect/turf_decal/stripes/line{
	dir = 4
	},
/obj/machinery/light/small/directional/west,
/turf/open/floor/mineral/plastitanium,
/area/shuttle/syndicate/hallway)
"Sa" = (
/obj/effect/decal/syndie_logo{
	icon_state = "logo18"
	},
/turf/open/floor/mineral/plastitanium,
/area/shuttle/syndicate/bridge)
"Sr" = (
/obj/machinery/light/floor,
/turf/open/floor/iron/dark,
/area/shuttle/syndicate/engineering)
"Sy" = (
/obj/structure/table/reinforced,
/obj/item/reagent_containers/cup/bottle/epinephrine{
	pixel_x = -3;
	pixel_y = 8
	},
/obj/item/reagent_containers/cup/bottle/multiver{
	pixel_x = 6;
	pixel_y = 8
	},
/obj/item/reagent_containers/cup/bottle/multiver{
	pixel_x = -3
	},
/obj/item/reagent_containers/cup/bottle/epinephrine{
	pixel_x = 6
	},
/turf/open/floor/iron/white,
/area/shuttle/syndicate/medical)
"Ts" = (
/obj/structure/fans/tiny,
/obj/machinery/door/airlock/external,
/obj/machinery/door/poddoor{
	id = "infiltrator_shuttle_entrance";
	name = "Outer Blast Door"
	},
/obj/effect/mapping_helpers/airlock/cyclelink_helper_multi{
	cycle_id = "infiltrator_entrance"
	},
/obj/docking_port/mobile/infiltrator{
	dir = 1;
	port_direction = 2
	},
/obj/effect/mapping_helpers/airlock/autoname,
/obj/effect/mapping_helpers/airlock/access/all/syndicate/general,
/turf/open/floor/plating,
/area/shuttle/syndicate/airlock)
"Ub" = (
/obj/structure/closet,
/obj/item/clothing/under/syndicate/scrubs,
/obj/item/clothing/gloves/latex/nitrile,
/obj/item/clothing/mask/breath/medical,
/obj/item/tank/internals/anesthetic,
/turf/open/floor/iron/white,
/area/shuttle/syndicate/medical)
"UF" = (
/obj/effect/turf_decal/stripes/line{
	dir = 9
	},
/turf/open/floor/iron/dark,
/area/shuttle/syndicate/airlock)
"UJ" = (
/obj/structure/table/reinforced,
/obj/item/storage/medkit/regular{
	pixel_x = -8;
	pixel_y = 8
	},
/obj/item/storage/medkit/regular{
	pixel_y = 8
	},
/obj/item/storage/medkit/regular{
	pixel_x = 8;
	pixel_y = 8
	},
/obj/item/storage/medkit/fire{
	pixel_x = -6
	},
/obj/item/storage/medkit/brute{
	pixel_x = 6
	},
/turf/open/floor/iron/white,
/area/shuttle/syndicate/medical)
"Vi" = (
/obj/machinery/porta_turret/syndicate/shuttle{
	dir = 10
	},
/turf/closed/wall/r_wall/plastitanium/syndicate,
/area/shuttle/syndicate/airlock)
"Vo" = (
/obj/structure/table/optable,
/turf/open/floor/iron/white,
/area/shuttle/syndicate/medical)
"Vv" = (
/obj/effect/turf_decal/stripes/corner{
	dir = 4
	},
/turf/open/floor/iron/dark,
/area/shuttle/syndicate/airlock)
"VJ" = (
/obj/effect/decal/syndie_logo{
	icon_state = "logo5"
	},
/turf/open/floor/mineral/plastitanium,
/area/shuttle/syndicate/bridge)
"VQ" = (
/obj/machinery/light/floor,
/obj/effect/turf_decal/stripes/line{
	dir = 5
	},
/obj/item/radio/intercom/directional/north,
/turf/open/floor/iron/dark,
/area/shuttle/syndicate/airlock)
"WN" = (
/obj/machinery/suit_storage_unit/syndicate,
/obj/effect/turf_decal/stripes/line{
	dir = 6
	},
/turf/open/floor/mineral/plastitanium,
/area/shuttle/syndicate/hallway)
"WR" = (
/obj/machinery/power/shuttle_engine/heater,
/obj/structure/window/reinforced/tinted/spawner/directional/north,
/obj/effect/turf_decal/stripes/line,
/turf/open/floor/plating/airless,
/area/shuttle/syndicate/engineering)
"Xf" = (
/obj/machinery/power/shuttle_engine/huge,
/turf/template_noop,
/area/shuttle/syndicate/engineering)
"Yc" = (
/obj/structure/chair/comfy/shuttle/tactical{
	dir = 1
	},
/obj/effect/decal/syndie_logo{
	icon_state = "logo7"
	},
/turf/open/floor/mineral/plastitanium,
/area/shuttle/syndicate/bridge)
"Yt" = (
/obj/effect/turf_decal/siding/thinplating_new/dark/corner{
	dir = 8
	},
/obj/machinery/newscaster/directional/north,
/turf/open/floor/mineral/plastitanium/red,
/area/shuttle/syndicate/hallway)
"YK" = (
/obj/effect/turf_decal/stripes/line{
	dir = 8
	},
/turf/open/floor/plating,
/area/shuttle/syndicate/engineering)
"Zl" = (
/obj/effect/turf_decal/stripes/corner,
/turf/open/floor/iron/dark,
/area/shuttle/syndicate/airlock)
"Zx" = (
/obj/effect/turf_decal/tile/blue/fourcorners,
/turf/open/floor/iron/white,
/area/shuttle/syndicate/medical)
"ZB" = (
/obj/effect/turf_decal/stripes/line{
	dir = 8
	},
/obj/effect/turf_decal/stripes/end{
	dir = 4
	},
/obj/machinery/light/small/directional/east,
/turf/open/floor/iron/recharge_floor,
/area/shuttle/syndicate/hallway)
"ZP" = (
/obj/structure/chair/comfy/shuttle/tactical{
	dir = 4
	},
/obj/effect/turf_decal/stripes/line{
	dir = 5
	},
/obj/item/radio/intercom/directional/north,
/turf/open/floor/mineral/plastitanium,
/area/shuttle/syndicate/bridge)

(1,1,1) = {"
mR
mR
mR
mR
mR
mR
mR
mR
mR
mR
mR
mR
mR
ke
ke
ke
ke
ke
ke
mR
mR
mR
"}
(2,1,1) = {"
mR
mR
mR
mR
mR
mR
mR
mR
Mt
Mt
Mt
Mt
Iv
HC
HC
HC
HC
HC
HC
HC
mR
mR
"}
(3,1,1) = {"
mR
mR
mR
mR
mR
kp
cK
cK
cD
cD
cD
cD
HC
sR
Sy
Ub
Kg
yO
nj
DF
xi
gx
"}
(4,1,1) = {"
mR
mR
Mt
Mt
DU
cD
iw
hA
PY
Ir
RJ
jX
HC
PN
Mv
Zx
Mv
Vo
nj
DF
xi
xi
"}
(5,1,1) = {"
mR
hG
hG
hG
hG
hG
HA
hA
hA
hA
hA
hA
HC
UJ
Zx
bi
Zx
Ex
nj
DF
xi
xi
"}
(6,1,1) = {"
AY
qn
ZP
dP
dP
hG
WN
hA
hA
QY
hA
hA
Lq
Mv
Mv
Zx
Ff
DV
Nr
Nr
st
mR
"}
(7,1,1) = {"
hG
Fc
Oc
Oc
DD
qn
hG
yI
yI
Dm
zV
hA
cn
Mv
Hm
Rl
Rl
Nr
Nr
Nr
Nr
Vi
"}
(8,1,1) = {"
vs
sq
VJ
hs
ap
jP
hG
tx
ko
Dm
cD
cD
Yt
yT
DV
Nr
Nr
DV
LB
fO
DV
Nr
"}
(9,1,1) = {"
vs
uM
rU
ff
jQ
Lr
wt
hA
hA
tb
vd
hy
hA
hA
dG
UF
fs
fs
Bs
EO
fO
Ts
"}
(10,1,1) = {"
vs
nK
Yc
eO
zh
Sa
wt
hA
hA
tb
vd
xb
hA
hA
dG
kB
hq
hq
Vv
Zl
Kh
pa
"}
(11,1,1) = {"
vs
ks
QK
iq
FJ
Pt
hG
tx
ko
Dm
cD
cD
JZ
KD
DV
Nr
Nr
DV
VQ
pk
DV
Nr
"}
(12,1,1) = {"
hG
rO
Oc
Oc
DD
qn
hG
yI
yI
Dm
jF
hA
cn
KX
gm
IV
wn
Nr
Nr
Nr
Nr
Nm
"}
(13,1,1) = {"
go
qn
bd
EZ
EZ
hG
iw
hA
hA
zU
hA
hA
zg
KX
uo
uo
qD
DV
Nr
Nr
st
mR
"}
(14,1,1) = {"
mR
hG
hG
hG
hG
hG
HA
hA
hA
hA
hA
hA
Do
gw
KX
Sr
KX
iK
WR
He
oP
Xf
"}
(15,1,1) = {"
mR
mR
Mt
Mt
DU
cD
WN
hA
do
Ar
ZB
wG
Do
nL
uo
uo
Jz
aO
WR
He
oP
oP
"}
(16,1,1) = {"
mR
mR
mR
mR
mR
kI
bP
bP
cD
cD
cD
cD
Do
HD
YK
yU
oV
jz
WR
He
oP
oP
"}
(17,1,1) = {"
mR
mR
mR
mR
mR
mR
mR
mR
Mt
Mt
Mt
Mt
iH
Do
Do
Do
Do
Do
Do
Do
mR
mR
"}
(18,1,1) = {"
mR
mR
mR
mR
mR
mR
mR
mR
mR
mR
mR
mR
mR
Fl
Fl
Fl
Fl
Fl
Fl
mR
mR
mR
"}
