//MAP CONVERTED BY dmm2tgm.py THIS HEADER COMMENT PREVENTS RECONVERSION, DO NOT REMOVE
"a" = (
/obj/machinery/atmospherics/components/unary/vent_scrubber/on/layer2{
	dir = 4
	},
/obj/item/radio/intercom/directional/north,
/obj/effect/turf_decal/bot,
/obj/effect/landmark/secequipment,
/turf/open/floor/iron/smooth_edge,
/area/station/security/lockers)

(1,1,1) = {"
a
"}
