//MAP CONVERTED BY dmm2tgm.py THIS HEADER COMMENT PREVENTS RECONVERSION, DO NOT REMOVE
"a" = (
/obj/machinery/duct,
/obj/effect/turf_decal/tile/dark_green/opposingcorners,
/obj/machinery/atmospherics/components/unary/vent_scrubber/on/layer2{
	dir = 4
	},
/mob/living/basic/chicken/wife,
/turf/open/floor/iron,
/area/station/hallway/secondary/service)
"l" = (
/obj/machinery/duct,
/obj/structure/cable,
/obj/effect/turf_decal/tile/dark_green/opposingcorners,
/obj/machinery/atmospherics/pipe/smart/manifold4w/scrubbers/hidden/layer2,
/obj/machinery/firealarm/directional/east,
/mob/living/basic/chicken/cock/clucky,
/turf/open/floor/iron,
/area/station/hallway/secondary/service)
"o" = (
/turf/template_noop,
/area/template_noop)
"Y" = (
/obj/machinery/atmospherics/pipe/smart/manifold4w/supply/hidden/layer4,
/obj/machinery/atmospherics/pipe/smart/manifold4w/scrubbers/hidden/layer2,
/obj/structure/cable,
/obj/machinery/atmospherics/pipe/heat_exchanging/simple{
	dir = 5
	},
/mob/living/basic/cow/black/pipa,
/turf/open/floor/iron/kitchen_coldroom/freezerfloor,
/area/station/service/kitchen/coldroom)

(1,1,1) = {"
o
a
"}
(2,1,1) = {"
o
l
"}
(3,1,1) = {"
o
o
"}
(4,1,1) = {"
o
o
"}
(5,1,1) = {"
Y
o
"}
