//MAP CONVERTED BY dmm2tgm.py THIS HEADER COMMENT PREVENTS RECONVERSION, DO NOT REMOVE
"a" = (
/obj/effect/turf_decal/tile/red/half/contrasted{
	dir = 1
	},
/turf/open/floor/iron/dark,
/area/station/security/lockers)
"I" = (
/obj/effect/turf_decal/tile/red/anticorner/contrasted{
	dir = 4
	},
/obj/machinery/airalarm/directional/east,
/obj/machinery/recharge_station,
/turf/open/floor/iron/dark,
/area/station/security/lockers)

(1,1,1) = {"
a
"}
(2,1,1) = {"
I
"}
