//MAP CONVERTED BY dmm2tgm.py THIS HEADER COMMENT PREVENTS RECONVERSION, DO NOT REMOVE
"a" = (
/turf/template_noop,
/area/template_noop)
"b" = (
/obj/effect/decal/cleanable/dirt/dust,
/obj/structure/reagent_dispensers/watertank,
/turf/open/floor/plating,
/area/station/maintenance/central/lesser)
"c" = (
/obj/structure/chair{
	dir = 8
	},
/obj/machinery/atmospherics/pipe/smart/manifold4w/supply/hidden/layer4,
/obj/effect/landmark/start/lawyer,
/obj/structure/cable,
/turf/open/floor/wood,
/area/station/service/lawoffice)
"d" = (
/turf/closed/wall,
/area/station/service/lawoffice)
"e" = (
/obj/effect/spawner/random/structure/grille,
/turf/open/floor/plating,
/area/station/maintenance/central/lesser)
"f" = (
/turf/open/floor/plating,
/area/station/maintenance/central/lesser)
"g" = (
/obj/effect/mapping_helpers/broken_floor,
/obj/effect/spawner/random/structure/chair_maintenance{
	dir = 4
	},
/obj/effect/decal/cleanable/dirt/dust,
/turf/open/floor/plating,
/area/station/maintenance/central/lesser)
"h" = (
/obj/machinery/door/airlock/maintenance_hatch,
/obj/effect/mapping_helpers/airlock/access/all/service/lawyer,
/obj/effect/mapping_helpers/airlock/autoname,
/turf/open/floor/wood,
/area/station/service/lawoffice)
"i" = (
/obj/effect/landmark/event_spawn,
/obj/machinery/atmospherics/pipe/smart/manifold4w/scrubbers/hidden/layer2,
/obj/machinery/atmospherics/pipe/smart/manifold4w/supply/hidden/layer4,
/obj/structure/disposalpipe/segment{
	dir = 5
	},
/obj/structure/cable,
/turf/open/floor/wood,
/area/station/service/lawoffice)
"j" = (
/obj/effect/decal/cleanable/dirt,
/obj/effect/spawner/random/structure/grille,
/obj/structure/cable,
/turf/open/floor/plating,
/area/station/maintenance/central/lesser)
"k" = (
/obj/machinery/door/airlock/lawyer,
/obj/effect/mapping_helpers/airlock/access/all/service/lawyer,
/obj/effect/mapping_helpers/airlock/autoname,
/obj/machinery/atmospherics/pipe/smart/manifold4w/scrubbers/hidden/layer2,
/obj/machinery/atmospherics/pipe/smart/manifold4w/supply/hidden/layer4,
/obj/structure/disposalpipe/segment,
/obj/structure/cable,
/turf/open/floor/wood,
/area/station/service/lawoffice)
"l" = (
/obj/machinery/atmospherics/components/unary/vent_scrubber/on/layer2{
	dir = 8
	},
/obj/structure/disposalpipe/segment{
	dir = 4
	},
/turf/open/floor/wood,
/area/station/service/lawoffice)
"m" = (
/obj/structure/table/wood,
/obj/item/book/manual/wiki/security_space_law{
	pixel_x = 3;
	pixel_y = 2
	},
/obj/item/stamp/law{
	pixel_x = 4;
	pixel_y = 5
	},
/obj/item/pen/red{
	pixel_x = 4;
	pixel_y = 5
	},
/obj/item/flashlight/lamp/green{
	pixel_x = -9;
	pixel_y = 1
	},
/turf/open/floor/carpet,
/area/station/service/lawoffice)
"n" = (
/obj/effect/turf_decal/tile/neutral,
/obj/machinery/atmospherics/pipe/smart/manifold4w/supply/hidden/layer4,
/obj/machinery/atmospherics/pipe/smart/manifold4w/scrubbers/hidden/layer2,
/obj/machinery/light/directional/south,
/turf/open/floor/iron,
/area/station/hallway/primary/central)
"o" = (
/obj/effect/mapping_helpers/broken_floor,
/obj/effect/spawner/random/structure/crate,
/turf/open/floor/plating,
/area/station/maintenance/central/lesser)
"p" = (
/obj/machinery/power/apc/auto_name/directional/south,
/obj/structure/cable,
/turf/open/floor/wood,
/area/station/service/lawoffice)
"q" = (
/obj/structure/table/wood,
/obj/machinery/airalarm/directional/south,
/obj/machinery/light_switch/directional/east,
/turf/open/floor/wood,
/area/station/service/lawoffice)
"r" = (
/obj/effect/decal/cleanable/dirt,
/turf/open/floor/plating,
/area/station/maintenance/central/lesser)
"s" = (
/obj/machinery/atmospherics/components/unary/vent_pump/on/layer4{
	dir = 1
	},
/turf/open/floor/carpet,
/area/station/service/lawoffice)
"t" = (
/obj/machinery/portable_atmospherics/canister/air,
/obj/machinery/atmospherics/components/unary/portables_connector/visible/layer4,
/turf/open/floor/plating,
/area/station/maintenance/central/lesser)
"w" = (
/obj/effect/spawner/random/structure/crate,
/turf/open/floor/plating,
/area/station/maintenance/central/lesser)
"x" = (
/obj/structure/rack,
/obj/item/storage/briefcase{
	pixel_x = -3;
	pixel_y = 2
	},
/obj/item/storage/briefcase/secure{
	pixel_x = 2;
	pixel_y = -2
	},
/obj/item/taperecorder,
/obj/item/clothing/glasses/sunglasses,
/obj/item/clothing/glasses/sunglasses/big,
/obj/machinery/firealarm/directional/south,
/obj/machinery/camera/autoname/directional/south,
/turf/open/floor/wood,
/area/station/service/lawoffice)
"y" = (
/obj/effect/decal/cleanable/dirt/dust,
/turf/open/floor/plating,
/area/station/maintenance/central/lesser)
"z" = (
/obj/effect/turf_decal/tile/neutral,
/obj/machinery/atmospherics/pipe/smart/manifold4w/supply/hidden/layer4,
/obj/machinery/atmospherics/pipe/smart/manifold4w/scrubbers/hidden/layer2,
/obj/structure/disposalpipe/segment,
/obj/structure/cable,
/turf/open/floor/iron,
/area/station/hallway/primary/central)
"B" = (
/obj/structure/filingcabinet/employment,
/turf/open/floor/carpet,
/area/station/service/lawoffice)
"C" = (
/obj/structure/chair/office{
	dir = 4
	},
/obj/effect/landmark/start/lawyer,
/obj/machinery/button/curtain{
	id = "law";
	pixel_x = -26;
	pixel_y = -8
	},
/turf/open/floor/carpet,
/area/station/service/lawoffice)
"D" = (
/obj/effect/decal/cleanable/dirt/dust,
/obj/effect/spawner/random/structure/grille,
/obj/structure/cable,
/turf/open/floor/plating,
/area/station/maintenance/central/lesser)
"E" = (
/turf/closed/wall/r_wall,
/area/station/command/gateway)
"F" = (
/obj/effect/spawner/structure/window/reinforced,
/obj/structure/curtain/cloth/fancy/mechanical{
	id = "law"
	},
/turf/open/floor/plating,
/area/station/service/lawoffice)
"G" = (
/obj/structure/disposalpipe/segment{
	dir = 9
	},
/obj/machinery/light/small/directional/south,
/turf/open/floor/wood,
/area/station/service/lawoffice)
"H" = (
/obj/machinery/atmospherics/pipe/smart/manifold4w/scrubbers/hidden/layer2,
/obj/machinery/atmospherics/pipe/smart/manifold4w/supply/hidden/layer4,
/obj/structure/disposalpipe/segment,
/obj/structure/cable,
/turf/open/floor/wood,
/area/station/service/lawoffice)
"I" = (
/obj/structure/cable,
/obj/effect/spawner/random/structure/grille,
/turf/open/floor/plating,
/area/station/maintenance/central/lesser)
"J" = (
/obj/effect/spawner/random/trash/janitor_supplies,
/turf/open/floor/plating,
/area/station/maintenance/central/lesser)
"L" = (
/obj/structure/chair{
	dir = 8
	},
/turf/open/floor/wood,
/area/station/service/lawoffice)
"M" = (
/obj/machinery/disposal/bin,
/obj/structure/disposalpipe/trunk,
/turf/open/floor/wood,
/area/station/service/lawoffice)
"N" = (
/obj/structure/table/wood,
/obj/item/paper_bin,
/obj/item/pen,
/obj/machinery/atmospherics/pipe/smart/manifold4w/supply/hidden/layer4,
/turf/open/floor/carpet,
/area/station/service/lawoffice)
"P" = (
/obj/effect/spawner/random/structure/grille,
/obj/structure/cable,
/turf/open/floor/plating,
/area/station/maintenance/central/lesser)
"Q" = (
/obj/machinery/vending/wardrobe/law_wardrobe,
/turf/open/floor/carpet,
/area/station/service/lawoffice)
"R" = (
/obj/structure/cable,
/obj/effect/mapping_helpers/mail_sorting/service/law_office,
/obj/structure/disposalpipe/sorting/mail{
	dir = 4
	},
/turf/open/floor/iron,
/area/station/hallway/primary/central)
"S" = (
/obj/effect/turf_decal/tile/neutral,
/obj/machinery/atmospherics/pipe/smart/manifold4w/supply/hidden/layer4,
/obj/machinery/atmospherics/pipe/smart/manifold4w/scrubbers/hidden/layer2,
/turf/open/floor/iron,
/area/station/hallway/primary/central)
"U" = (
/obj/structure/closet/firecloset,
/obj/item/poster/random_contraband,
/turf/open/floor/plating,
/area/station/maintenance/central/lesser)
"V" = (
/obj/machinery/photocopier/prebuilt,
/turf/open/floor/carpet,
/area/station/service/lawoffice)
"W" = (
/obj/structure/table/wood,
/obj/machinery/fax{
	fax_name = "Law Office";
	name = "Law Office Fax Machine"
	},
/turf/open/floor/wood,
/area/station/service/lawoffice)
"Y" = (
/turf/closed/wall,
/area/station/maintenance/central/lesser)
"Z" = (
/obj/machinery/light/directional/west,
/turf/open/floor/carpet,
/area/station/service/lawoffice)

(1,1,1) = {"
a
a
E
E
E
E
E
E
E
E
"}
(2,1,1) = {"
a
n
d
V
C
Z
B
d
w
Y
"}
(3,1,1) = {"
a
a
F
m
N
s
Q
d
f
y
"}
(4,1,1) = {"
a
S
F
L
c
p
d
d
P
I
"}
(5,1,1) = {"
R
z
k
H
i
x
d
o
j
D
"}
(6,1,1) = {"
a
S
F
W
l
q
d
Y
e
a
"}
(7,1,1) = {"
a
a
F
M
G
d
d
g
t
a
"}
(8,1,1) = {"
a
a
d
d
h
d
U
b
y
a
"}
(9,1,1) = {"
a
a
a
Y
J
f
r
y
a
a
"}
