//MAP CONVERTED BY dmm2tgm.py THIS HEADER COMMENT PREVENTS RECONVERSION, DO NOT REMOVE
"a" = (
/obj/structure/table/reinforced,
/obj/effect/turf_decal/bot,
/obj/item/bodypart/arm/right/robot{
	pixel_x = 3
	},
/obj/item/bodypart/arm/left/robot{
	pixel_x = -3
	},
/obj/structure/extinguisher_cabinet/directional/north,
/obj/machinery/firealarm/directional/west,
/obj/item/assembly/flash/handheld{
	pixel_x = 6;
	pixel_y = 13
	},
/obj/item/assembly/flash/handheld{
	pixel_x = 6;
	pixel_y = 13
	},
/obj/item/assembly/flash/handheld{
	pixel_x = 6;
	pixel_y = 13
	},
/obj/item/assembly/flash/handheld{
	pixel_x = 6;
	pixel_y = 13
	},
/obj/item/assembly/flash/handheld{
	pixel_x = 6;
	pixel_y = 13
	},
/obj/machinery/ecto_sniffer{
	pixel_x = -6;
	pixel_y = 6
	},
/obj/item/circuitboard/mecha/ripley/main{
	pixel_x = -9;
	pixel_y = -10
	},
/obj/item/circuitboard/mecha/ripley/peripherals{
	pixel_x = -4;
	pixel_y = -7
	},
/obj/item/mecha_parts/core,
/turf/open/floor/iron/dark/textured,
/area/station/science/robotics/lab)

(1,1,1) = {"
a
"}
