//MAP CONVERTED BY dmm2tgm.py THIS HEADER COMMENT PREVENTS RECONVERSION, DO NOT REMOVE
"a" = (
/mob/living/basic/mouse/factory/pizdos,
/turf/open/floor/plating,
/area/station/maintenance/disposal)

(1,1,1) = {"
a
"}
