//MAP CONVERTED BY dmm2tgm.py THIS HEADER COMMENT PREVENTS RECONVERSION, DO NOT REMOVE
"a" = (
/turf/template_noop,
/area/template_noop)
"g" = (
/obj/structure/chair{
	dir = 1
	},
/obj/machinery/atmospherics/pipe/smart/manifold4w/supply/hidden/layer4,
/obj/effect/landmark/start/magistrate,
/turf/open/floor/wood,
/area/station/command/heads_quarters/magistrate)
"j" = (
/obj/structure/closet/secure_closet/magistrate,
/turf/open/floor/wood,
/area/station/command/heads_quarters/magistrate)
"k" = (
/obj/structure/table/wood,
/obj/effect/turf_decal/siding/wood,
/obj/item/paper_bin,
/obj/item/gavelblock{
	pixel_x = -16;
	pixel_y = 2
	},
/obj/item/gavelhammer{
	pixel_x = -18;
	pixel_y = 4
	},
/obj/item/flashlight/lamp/green{
	pixel_x = -20;
	pixel_y = 2
	},
/obj/item/pen/fountain{
	pixel_y = 2;
	pixel_x = 1
	},
/obj/item/stamp/magistrate,
/turf/open/floor/carpet/black,
/area/station/command/heads_quarters/magistrate)
"l" = (
/obj/item/radio/intercom/directional/south,
/obj/item/kirbyplants/random,
/turf/open/floor/wood,
/area/station/command/heads_quarters/magistrate)
"m" = (
/obj/machinery/atmospherics/pipe/smart/manifold4w/supply/hidden/layer4,
/turf/open/floor/carpet/black,
/area/station/command/heads_quarters/magistrate)
"n" = (
/obj/structure/filingcabinet/employment,
/turf/open/floor/carpet/black,
/area/station/command/heads_quarters/magistrate)
"q" = (
/turf/closed/wall/r_wall,
/area/station/command/heads_quarters/magistrate)
"t" = (
/obj/effect/turf_decal/siding/wood,
/obj/machinery/power/apc/auto_name/directional/east,
/obj/structure/cable,
/obj/machinery/atmospherics/pipe/smart/manifold4w/supply/hidden/layer4,
/turf/open/floor/carpet/black,
/area/station/command/heads_quarters/magistrate)
"v" = (
/obj/machinery/door/firedoor,
/obj/effect/spawner/structure/window/reinforced,
/obj/structure/curtain/cloth/fancy/mechanical{
	id = "mag"
	},
/turf/open/floor/plating,
/area/station/command/heads_quarters/magistrate)
"y" = (
/obj/machinery/photocopier/prebuilt,
/obj/machinery/light_switch/directional/east,
/turf/open/floor/carpet/black,
/area/station/command/heads_quarters/magistrate)
"z" = (
/obj/structure/table/wood,
/obj/machinery/computer/records/security/laptop{
	dir = 4;
	pixel_x = 0;
	pixel_y = 3
	},
/turf/open/floor/carpet/black,
/area/station/command/heads_quarters/magistrate)
"D" = (
/obj/structure/cable,
/obj/machinery/atmospherics/components/unary/vent_scrubber/on/layer2{
	dir = 8
	},
/turf/open/floor/wood,
/area/station/command/heads_quarters/magistrate)
"K" = (
/obj/effect/landmark/event_spawn,
/obj/structure/cable,
/obj/machinery/atmospherics/pipe/smart/manifold4w/supply/hidden/layer4,
/turf/open/floor/wood,
/area/station/command/heads_quarters/magistrate)
"L" = (
/obj/structure/table/wood,
/obj/machinery/airalarm/directional/east,
/obj/machinery/fax{
	fax_name = "Magistrate's Office";
	name = "Magistrate's Fax Machine"
	},
/turf/open/floor/wood,
/area/station/command/heads_quarters/magistrate)
"M" = (
/obj/effect/turf_decal/siding/wood{
	dir = 8
	},
/obj/structure/cable,
/obj/machinery/atmospherics/pipe/smart/manifold4w/scrubbers/hidden/layer2,
/obj/machinery/atmospherics/pipe/smart/manifold4w/supply/hidden/layer4,
/obj/structure/disposalpipe/segment{
	dir = 8
	},
/obj/machinery/door/firedoor,
/obj/machinery/door/airlock/corporate,
/obj/effect/mapping_helpers/airlock/autoname,
/obj/effect/mapping_helpers/airlock/access/any/command/magistrate,
/obj/effect/landmark/navigate_destination,
/turf/open/floor/wood,
/area/station/command/heads_quarters/magistrate)
"N" = (
/obj/machinery/door/firedoor,
/obj/machinery/door/airlock/grunge{
	name = "Courtroom"
	},
/obj/structure/cable,
/obj/effect/mapping_helpers/airlock/access/any/command/magistrate,
/turf/open/floor/iron/dark,
/area/station/command/heads_quarters/magistrate)
"O" = (
/obj/structure/rack,
/obj/item/taperecorder{
	pixel_x = -4;
	pixel_y = 5
	},
/obj/item/clothing/head/helmet/skull{
	desc = "Бедный Йорик...";
	pixel_x = 6;
	pixel_y = 6
	},
/turf/open/floor/wood,
/area/station/command/heads_quarters/magistrate)
"Q" = (
/obj/machinery/atmospherics/pipe/smart/manifold4w/supply/hidden/layer4,
/obj/machinery/papershredder,
/turf/open/floor/wood,
/area/station/command/heads_quarters/magistrate)
"R" = (
/obj/effect/turf_decal/siding/wood,
/obj/structure/table/wood,
/obj/machinery/button/curtain{
	id = "mag";
	pixel_x = -26;
	pixel_y = 4
	},
/obj/item/book/manual/wiki/security_space_law,
/obj/item/pen/red,
/obj/item/megaphone{
	pixel_x = -4;
	pixel_y = 17
	},
/turf/open/floor/carpet/black,
/area/station/command/heads_quarters/magistrate)
"S" = (
/obj/machinery/atmospherics/pipe/smart/manifold4w/scrubbers/hidden/layer2,
/obj/machinery/atmospherics/pipe/smart/manifold4w/supply/hidden/layer4,
/obj/structure/disposalpipe/junction/flip,
/turf/open/floor/iron,
/area/station/hallway/primary/fore)
"U" = (
/obj/machinery/disposal/bin,
/obj/structure/disposalpipe/trunk{
	dir = 1
	},
/obj/machinery/camera/autoname/directional/south,
/obj/machinery/firealarm/directional/south,
/turf/open/floor/wood,
/area/station/command/heads_quarters/magistrate)
"W" = (
/obj/structure/cable,
/obj/machinery/atmospherics/pipe/smart/manifold4w/scrubbers/hidden/layer2,
/obj/machinery/atmospherics/pipe/smart/manifold4w/supply/hidden/layer4,
/obj/structure/disposalpipe/segment{
	dir = 10
	},
/turf/open/floor/wood,
/area/station/command/heads_quarters/magistrate)
"X" = (
/obj/structure/chair/office,
/obj/effect/landmark/start/magistrate,
/obj/machinery/atmospherics/components/unary/vent_pump/on/layer4{
	dir = 4
	},
/turf/open/floor/carpet/black,
/area/station/command/heads_quarters/magistrate)
"Y" = (
/obj/machinery/light/directional/north,
/obj/machinery/computer/prisoner/management{
	req_access = list("lawyer")
	},
/turf/open/floor/carpet/black,
/area/station/command/heads_quarters/magistrate)
"Z" = (
/obj/structure/cable,
/turf/open/floor/wood,
/area/station/command/heads_quarters/magistrate)

(1,1,1) = {"
a
a
a
a
a
S
a
a
"}
(2,1,1) = {"
a
a
a
a
a
a
a
a
"}
(3,1,1) = {"
a
a
a
a
a
a
a
a
"}
(4,1,1) = {"
a
a
a
a
a
a
a
a
"}
(5,1,1) = {"
a
a
a
a
a
a
a
a
"}
(6,1,1) = {"
q
q
q
q
v
M
v
q
"}
(7,1,1) = {"
q
n
z
R
Q
W
U
q
"}
(8,1,1) = {"
q
Y
X
k
g
D
l
q
"}
(9,1,1) = {"
q
y
m
t
K
Z
Z
N
"}
(10,1,1) = {"
q
q
q
q
O
L
j
q
"}
(11,1,1) = {"
a
a
a
q
q
q
q
q
"}
