//MAP CONVERTED BY dmm2tgm.py THIS HEADER COMMENT PREVENTS RECONVERSION, DO NOT REMOVE
"a" = (
/obj/effect/decal/cleanable/dirt/dust,
/obj/structure/chair/office{
	dir = 1;
	name = "grimy chair"
	},
/mob/living/basic/mothroach/wrynroach{
	name = "Жужука"
	},
/turf/open/floor/iron,
/area/station/maintenance/department/medical/central)

(1,1,1) = {"
a
"}
