//MAP CONVERTED BY dmm2tgm.py THIS HEADER COMMENT PREVENTS RECONVERSION, DO NOT REMOVE
"a" = (
/turf/template_noop,
/area/template_noop)
"o" = (
/obj/structure/chair/comfy/brown{
	dir = 4
	},
/turf/open/floor/carpet/executive,
/area/station/command/meeting_room)
"F" = (
/obj/structure/chair/comfy/brown{
	dir = 8
	},
/turf/open/floor/carpet/executive,
/area/station/command/meeting_room)
"Q" = (
/obj/structure/chair/comfy/brown,
/turf/open/floor/carpet/executive,
/area/station/command/meeting_room)
"Z" = (
/obj/machinery/atmospherics/pipe/smart/manifold4w/supply/hidden/layer4,
/obj/machinery/atmospherics/pipe/smart/manifold4w/scrubbers/hidden/layer2,
/obj/structure/cable,
/obj/structure/statue/gold/galactic_map,
/turf/open/floor/carpet/executive,
/area/station/command/meeting_room)

(1,1,1) = {"
a
o
o
o
a
"}
(2,1,1) = {"
Q
a
a
a
a
"}
(3,1,1) = {"
Q
a
a
a
Z
"}
(4,1,1) = {"
a
F
F
F
a
"}
