//MAP CONVERTED BY dmm2tgm.py THIS HEADER COMMENT PREVENTS RECONVERSION, DO NOT REMOVE
"a" = (
/obj/effect/turf_decal/siding/white{
	dir = 9
	},
/obj/machinery/atmospherics/pipe/smart/manifold4w/scrubbers/hidden/layer2,
/obj/machinery/atmospherics/pipe/smart/manifold4w/supply/hidden/layer4,
/obj/structure/cable,
/turf/open/floor/iron/herringbone,
/area/station/commons/fitness/recreation)
"b" = (
/obj/machinery/airalarm/directional/west,
/obj/effect/turf_decal/trimline/dark_green/filled/line{
	dir = 4
	},
/obj/machinery/cryopod{
	dir = 4
	},
/turf/open/floor/iron/white,
/area/station/common/cryopods)
"d" = (
/obj/machinery/atmospherics/pipe/smart/manifold4w/scrubbers/hidden/layer2,
/obj/machinery/atmospherics/pipe/smart/manifold4w/supply/hidden/layer4,
/obj/effect/turf_decal/trimline/dark_green/line{
	dir = 6
	},
/obj/machinery/power/apc/auto_name/directional/east,
/obj/structure/cable,
/turf/open/floor/iron/white,
/area/station/common/cryopods)
"i" = (
/turf/template_noop,
/area/template_noop)
"j" = (
/obj/machinery/atmospherics/pipe/smart/manifold4w/scrubbers/hidden/layer2,
/obj/machinery/atmospherics/pipe/smart/manifold4w/supply/hidden/layer4,
/obj/machinery/door/airlock/public/glass{
	name = "Locker Room"
	},
/obj/structure/cable,
/turf/open/floor/iron,
/area/station/common/cryopods)
"m" = (
/obj/effect/spawner/structure/window/reinforced,
/turf/open/floor/plating,
/area/station/common/cryopods)
"t" = (
/obj/effect/turf_decal/tile/neutral{
	dir = 1
	},
/obj/machinery/atmospherics/pipe/smart/manifold4w/scrubbers/hidden/layer2,
/obj/machinery/atmospherics/pipe/smart/manifold4w/supply/hidden/layer4,
/obj/structure/cable,
/turf/open/floor/iron,
/area/station/commons/fitness/recreation)
"u" = (
/obj/machinery/light/small/directional/north,
/obj/machinery/atmospherics/components/unary/vent_pump/on/layer4{
	dir = 4
	},
/obj/effect/turf_decal/trimline/dark_green/line{
	dir = 9
	},
/turf/open/floor/iron/white,
/area/station/common/cryopods)
"x" = (
/obj/effect/turf_decal/trimline/dark_green/filled/line{
	dir = 4
	},
/obj/machinery/cryopod{
	dir = 4
	},
/turf/open/floor/iron/white,
/area/station/common/cryopods)
"A" = (
/obj/item/radio/intercom/directional/east,
/obj/machinery/atmospherics/pipe/smart/manifold4w/supply/hidden/layer4,
/obj/effect/turf_decal/trimline/dark_green/line{
	dir = 5
	},
/obj/machinery/computer/cryopod/directional/north,
/turf/open/floor/iron/white,
/area/station/common/cryopods)
"K" = (
/obj/effect/turf_decal/siding/white{
	dir = 1
	},
/obj/machinery/atmospherics/pipe/smart/manifold4w/scrubbers/hidden/layer2,
/obj/machinery/atmospherics/pipe/smart/manifold4w/supply/hidden/layer4,
/obj/structure/cable,
/turf/open/floor/iron/herringbone,
/area/station/commons/fitness/recreation)
"T" = (
/obj/machinery/atmospherics/components/unary/vent_scrubber/on/layer2{
	dir = 4
	},
/obj/effect/turf_decal/trimline/dark_green/line{
	dir = 10
	},
/turf/open/floor/iron/white,
/area/station/common/cryopods)
"U" = (
/obj/machinery/atmospherics/pipe/smart/manifold4w/supply/hidden/layer4,
/obj/machinery/atmospherics/pipe/smart/manifold4w/scrubbers/hidden/layer2,
/obj/structure/cable,
/turf/open/floor/iron,
/area/station/commons/fitness/recreation)
"W" = (
/obj/effect/decal/cleanable/dirt,
/obj/effect/turf_decal/siding/white{
	dir = 5
	},
/obj/machinery/atmospherics/pipe/smart/manifold4w/scrubbers/hidden/layer2,
/obj/machinery/atmospherics/pipe/smart/manifold4w/supply/hidden/layer4,
/obj/structure/cable,
/turf/open/floor/iron/herringbone,
/area/station/commons/fitness/recreation)

(1,1,1) = {"
b
x
m
i
i
"}
(2,1,1) = {"
u
T
m
i
i
"}
(3,1,1) = {"
A
d
j
t
a
"}
(4,1,1) = {"
i
i
i
i
K
"}
(5,1,1) = {"
i
i
i
i
K
"}
(6,1,1) = {"
i
i
i
i
K
"}
(7,1,1) = {"
i
i
i
i
K
"}
(8,1,1) = {"
i
i
i
i
K
"}
(9,1,1) = {"
i
i
i
i
W
"}
(10,1,1) = {"
i
i
i
i
U
"}
(11,1,1) = {"
i
i
i
i
U
"}
