//MAP CONVERTED BY dmm2tgm.py THIS HEADER COMMENT PREVENTS RECONVERSION, DO NOT REMOVE
"a" = (
/obj/effect/turf_decal/siding/wood/corner{
	dir = 4
	},
/turf/open/floor/carpet/blue,
/area/station/command/heads_quarters/blueshield)
"b" = (
/obj/machinery/atmospherics/components/unary/vent_pump/on/layer4,
/obj/structure/table/wood,
/obj/effect/turf_decal/siding/wood,
/obj/machinery/button/door{
	id = "ntr_bs_privacy";
	name = "Privacy Shutters Control";
	req_access = list("command");
	pixel_y = 6
	},
/obj/item/flashlight/lamp/green{
	pixel_y = 8;
	pixel_x = 15
	},
/obj/effect/spawner/random/special_lighter{
	pixel_x = -9
	},
/obj/machinery/button/door{
	id = "ntr_privacy";
	name = "Privacy Shutters Control";
	req_access = list("nanotrasen_representative");
	pixel_y = -3
	},
/turf/open/floor/carpet/royalblack,
/area/station/command/heads_quarters/nanotrasen_representative)
"c" = (
/obj/machinery/requests_console/directional/south{
	name = "Nanotrasen Representative's Requests Console";
	department = "Nanotrasen Representative's Office"
	},
/obj/machinery/light_switch/directional/west,
/obj/effect/mapping_helpers/requests_console/information,
/obj/effect/mapping_helpers/requests_console/announcement,
/obj/effect/mapping_helpers/requests_console/assistance,
/obj/machinery/disposal/bin,
/obj/structure/disposalpipe/trunk{
	dir = 1
	},
/turf/open/floor/wood/large,
/area/station/command/heads_quarters/nanotrasen_representative)
"d" = (
/obj/machinery/light/directional/west,
/obj/machinery/digital_clock/directional/west,
/obj/structure/filingcabinet/chestdrawer{
	pixel_y = 2
	},
/obj/effect/turf_decal/siding/wood{
	dir = 10
	},
/obj/machinery/camera/directional/west{
	c_tag = "Nanotrasen Representative's Office"
	},
/obj/item/folder/blue{
	pixel_y = 12
	},
/obj/item/folder/blue{
	pixel_y = 11;
	pixel_x = -3
	},
/turf/open/floor/carpet/royalblack,
/area/station/command/heads_quarters/nanotrasen_representative)
"e" = (
/obj/machinery/portable_atmospherics/canister/air,
/turf/open/floor/plating,
/area/station/maintenance/department/bridge)
"g" = (
/obj/machinery/atmospherics/pipe/smart/manifold4w/scrubbers/hidden/layer2,
/obj/machinery/door/firedoor,
/obj/structure/cable,
/obj/machinery/door/airlock/corporate{
	id_tag = "ntr_door";
	name = "Nanotrasen Representative's Office"
	},
/obj/effect/mapping_helpers/airlock/access/all/command/nanotrasen_representative,
/obj/effect/landmark/navigate_destination,
/turf/open/floor/iron/dark,
/area/station/command/heads_quarters/nanotrasen_representative)
"h" = (
/obj/structure/disposalpipe/segment{
	dir = 10
	},
/turf/open/floor/wood/large,
/area/station/command/heads_quarters/blueshield)
"j" = (
/obj/machinery/airalarm/directional/north,
/obj/effect/turf_decal/siding/wood{
	dir = 5
	},
/obj/machinery/modular_computer/preset/command,
/obj/machinery/button/door/directional/east{
	pixel_y = -7;
	name = "Door Control";
	id = "ntr_door";
	req_access = list("nanotrasen_representative");
	normaldoorcontrol = 1;
	specialfunctions = 3
	},
/obj/machinery/button/door/directional/east{
	pixel_y = 5;
	name = "Door Bolt Control";
	id = "ntr_door";
	req_access = list("nanotrasen_representative");
	normaldoorcontrol = 1;
	specialfunctions = 4
	},
/turf/open/floor/carpet/royalblack,
/area/station/command/heads_quarters/nanotrasen_representative)
"k" = (
/obj/structure/chair/sofa/corp/right{
	dir = 1
	},
/obj/effect/turf_decal/siding/thinplating_new/dark{
	dir = 5
	},
/turf/open/floor/iron/dark/textured_large,
/area/station/maintenance/department/bridge)
"l" = (
/obj/effect/turf_decal/siding/wood{
	dir = 4
	},
/obj/structure/chair/comfy/corp,
/obj/effect/landmark/start/nanotrasen_representative,
/turf/open/floor/carpet/royalblack,
/area/station/command/heads_quarters/nanotrasen_representative)
"m" = (
/obj/structure/cable,
/obj/machinery/atmospherics/pipe/smart/manifold4w/supply/hidden/layer4,
/obj/structure/disposalpipe/junction/flip{
	dir = 8
	},
/obj/machinery/atmospherics/pipe/smart/manifold4w/scrubbers/hidden/layer2,
/obj/structure/chair/comfy/brown{
	dir = 1
	},
/mob/living/basic/pet/cat/floppa{
	dir = 1
	},
/turf/open/floor/wood/large,
/area/station/command/heads_quarters/blueshield)
"n" = (
/obj/effect/spawner/structure/window/reinforced,
/obj/machinery/door/poddoor/shutters/preopen{
	id = "ntr_bs_privacy";
	name = "Privacy Shutters"
	},
/turf/open/floor/plating,
/area/station/command/heads_quarters/blueshield)
"o" = (
/obj/machinery/atmospherics/components/unary/vent_scrubber/on/layer2,
/obj/structure/table/wood,
/obj/effect/turf_decal/siding/wood{
	dir = 10
	},
/obj/item/paper_bin{
	pixel_y = 4
	},
/obj/effect/spawner/random/special_lighter{
	pixel_x = -9;
	pixel_y = 4
	},
/obj/item/pen/blue{
	pixel_x = -6
	},
/turf/open/floor/carpet/blue,
/area/station/command/heads_quarters/blueshield)
"p" = (
/obj/structure/cable,
/obj/machinery/atmospherics/pipe/smart/manifold4w/supply/hidden/layer4,
/obj/structure/disposalpipe/segment,
/obj/machinery/door/firedoor,
/obj/machinery/door/airlock/corporate{
	id_tag = "blueshield_door";
	name = "Blueshield's Office"
	},
/obj/effect/mapping_helpers/airlock/access/all/command/blueshield,
/obj/effect/landmark/navigate_destination,
/turf/open/floor/iron/dark,
/area/station/command/heads_quarters/blueshield)
"q" = (
/obj/item/radio/intercom/directional/north,
/obj/effect/turf_decal/siding/wood{
	dir = 1
	},
/turf/open/floor/carpet/blue,
/area/station/command/heads_quarters/blueshield)
"r" = (
/obj/structure/cable,
/obj/machinery/atmospherics/pipe/smart/manifold4w/supply/hidden/layer4,
/obj/machinery/atmospherics/pipe/smart/manifold4w/scrubbers/hidden/layer2,
/obj/structure/disposalpipe/segment{
	dir = 4
	},
/obj/structure/chair/comfy/brown{
	dir = 1
	},
/turf/open/floor/wood/large,
/area/station/command/heads_quarters/nanotrasen_representative)
"s" = (
/turf/closed/wall/r_wall,
/area/station/command/heads_quarters/nanotrasen_representative)
"t" = (
/obj/machinery/door/airlock/maintenance{
	name = "Command Maintenance"
	},
/obj/structure/cable,
/obj/machinery/atmospherics/pipe/smart/manifold4w/supply/hidden/layer4,
/obj/machinery/atmospherics/pipe/smart/manifold4w/scrubbers/hidden/layer2,
/obj/structure/disposalpipe/segment{
	dir = 4
	},
/obj/effect/mapping_helpers/airlock/access/all/command/nanotrasen_representative,
/turf/open/floor/plating,
/area/station/command/heads_quarters/nanotrasen_representative)
"u" = (
/obj/structure/disposalpipe/segment{
	dir = 4
	},
/turf/open/floor/wood/large,
/area/station/command/heads_quarters/blueshield)
"v" = (
/obj/structure/cable,
/obj/effect/spawner/structure/window/reinforced,
/obj/machinery/door/poddoor/shutters/preopen{
	id = "ntr_privacy";
	name = "Privacy Shutters"
	},
/turf/open/floor/plating,
/area/station/command/heads_quarters/nanotrasen_representative)
"w" = (
/obj/item/radio/intercom/directional/north,
/obj/effect/turf_decal/siding/wood{
	dir = 1
	},
/turf/open/floor/carpet/royalblack,
/area/station/command/heads_quarters/nanotrasen_representative)
"x" = (
/obj/structure/cable,
/obj/machinery/atmospherics/pipe/smart/manifold4w/supply/hidden/layer4,
/obj/machinery/atmospherics/pipe/smart/manifold4w/scrubbers/hidden/layer2,
/obj/structure/disposalpipe/junction/flip{
	dir = 8
	},
/turf/open/floor/wood/large,
/area/station/command/heads_quarters/nanotrasen_representative)
"y" = (
/obj/effect/turf_decal/siding/wood,
/obj/machinery/holopad/secure,
/turf/open/floor/carpet/blue,
/area/station/command/heads_quarters/blueshield)
"z" = (
/obj/effect/turf_decal/siding/wood/corner{
	dir = 1
	},
/turf/open/floor/carpet/royalblack,
/area/station/command/heads_quarters/nanotrasen_representative)
"A" = (
/obj/machinery/suit_storage_unit/blueshield,
/turf/open/floor/wood/large,
/area/station/command/heads_quarters/blueshield)
"B" = (
/obj/machinery/atmospherics/components/unary/vent_pump/on/layer4,
/obj/structure/table/wood,
/obj/effect/turf_decal/siding/wood,
/obj/machinery/button/door{
	id = "ntr_bs_privacy";
	name = "Privacy Shutters Control";
	req_access = list("command");
	pixel_y = 6
	},
/obj/item/flashlight/lamp{
	pixel_x = -15;
	pixel_y = 4
	},
/obj/item/cigarette/cigar/cohiba{
	pixel_x = 6;
	pixel_y = -2
	},
/obj/machinery/button/door{
	id = "blueshield_privacy";
	name = "Privacy Shutters Control";
	req_access = list("blueshield");
	pixel_y = -3
	},
/turf/open/floor/carpet/blue,
/area/station/command/heads_quarters/blueshield)
"C" = (
/obj/structure/cable,
/obj/machinery/atmospherics/pipe/smart/manifold4w/supply/hidden/layer4,
/obj/structure/disposalpipe/segment,
/obj/machinery/power/apc/auto_name/directional/west,
/turf/open/floor/wood/large,
/area/station/command/heads_quarters/blueshield)
"E" = (
/obj/machinery/firealarm/directional/south,
/obj/structure/table/wood,
/obj/item/storage/fancy/donut_box,
/turf/open/floor/wood/large,
/area/station/command/heads_quarters/blueshield)
"F" = (
/obj/machinery/airalarm/directional/north,
/obj/effect/turf_decal/siding/wood{
	dir = 9
	},
/obj/machinery/computer/crew,
/obj/machinery/button/door/directional/west{
	pixel_y = -7;
	id = "blueshield_door";
	name = "Door Control";
	req_access = list("blueshield");
	specialfunctions = 3;
	normaldoorcontrol = 1
	},
/obj/machinery/button/door/directional/west{
	id = "blueshield_door";
	name = "Door Bolts Control";
	req_access = list("blueshield");
	specialfunctions = 4;
	normaldoorcontrol = 1;
	pixel_y = 5
	},
/turf/open/floor/carpet/blue,
/area/station/command/heads_quarters/blueshield)
"G" = (
/obj/machinery/status_display/evac/directional/north,
/obj/structure/closet/secure_closet/nanotrasen_representative,
/obj/effect/turf_decal/siding/wood{
	dir = 9
	},
/obj/structure/sign/nanotrasen/directional/west,
/turf/open/floor/carpet/royalblack,
/area/station/command/heads_quarters/nanotrasen_representative)
"H" = (
/obj/machinery/light_switch/directional/east,
/obj/machinery/requests_console/directional/south{
	name = "Blueshield's Requests Console";
	department = "Blueshield's Office"
	},
/obj/effect/mapping_helpers/requests_console/information,
/obj/effect/mapping_helpers/requests_console/announcement,
/obj/effect/mapping_helpers/requests_console/assistance,
/obj/structure/disposalpipe/trunk{
	dir = 1
	},
/obj/machinery/disposal/bin,
/turf/open/floor/wood/large,
/area/station/command/heads_quarters/blueshield)
"I" = (
/obj/machinery/light/directional/east,
/obj/machinery/digital_clock/directional/east,
/obj/structure/closet/cabinet,
/obj/item/reagent_containers/cup/glass/drinkingglass,
/obj/item/reagent_containers/cup/glass/drinkingglass,
/obj/item/reagent_containers/cup/glass/drinkingglass,
/obj/item/reagent_containers/cup/glass/bottle/whiskey,
/obj/effect/turf_decal/siding/wood{
	dir = 6
	},
/obj/machinery/camera/directional/east{
	c_tag = "Blueshield's Office"
	},
/turf/open/floor/carpet/blue,
/area/station/command/heads_quarters/blueshield)
"J" = (
/obj/structure/cable,
/obj/machinery/atmospherics/pipe/smart/manifold4w/supply/hidden/layer4,
/obj/machinery/atmospherics/pipe/smart/manifold4w/scrubbers/hidden/layer2,
/obj/structure/disposalpipe/segment{
	dir = 4
	},
/turf/open/floor/wood/large,
/area/station/command/heads_quarters/nanotrasen_representative)
"K" = (
/obj/machinery/atmospherics/pipe/smart/manifold4w/supply/hidden/layer4,
/obj/structure/disposalpipe/segment{
	dir = 4
	},
/turf/open/floor/wood/large,
/area/station/command/heads_quarters/blueshield)
"L" = (
/obj/effect/turf_decal/siding/wood{
	dir = 5
	},
/obj/machinery/photocopier/prebuilt,
/obj/machinery/newscaster/directional/north,
/obj/machinery/light/directional/north,
/turf/open/floor/carpet/blue,
/area/station/command/heads_quarters/blueshield)
"N" = (
/obj/machinery/firealarm/directional/south,
/obj/structure/table/wood,
/obj/machinery/fax{
	fax_name = "Nanotrasen Representative's Office";
	name = "Nanotrasen Representative's Fax Machine"
	},
/turf/open/floor/wood/large,
/area/station/command/heads_quarters/nanotrasen_representative)
"O" = (
/obj/effect/turf_decal/siding/wood{
	dir = 9
	},
/obj/machinery/photocopier/prebuilt,
/obj/machinery/newscaster/directional/north,
/obj/machinery/light/directional/north,
/turf/open/floor/carpet/royalblack,
/area/station/command/heads_quarters/nanotrasen_representative)
"P" = (
/obj/effect/spawner/random/engineering/atmospherics_portable,
/obj/structure/railing{
	dir = 4
	},
/obj/effect/decal/cleanable/dirt/dust,
/turf/open/floor/plating,
/area/station/maintenance/department/bridge)
"Q" = (
/obj/effect/turf_decal/siding/wood{
	dir = 8
	},
/obj/structure/chair/comfy/black,
/obj/effect/landmark/start/blueshield,
/turf/open/floor/carpet/blue,
/area/station/command/heads_quarters/blueshield)
"R" = (
/obj/structure/chair/sofa/corp/left{
	dir = 1
	},
/obj/effect/turf_decal/siding/thinplating_new/dark{
	dir = 9
	},
/turf/open/floor/iron/dark/textured_large,
/area/station/maintenance/department/bridge)
"S" = (
/obj/effect/turf_decal/siding/wood,
/obj/machinery/holopad/secure,
/turf/open/floor/carpet/royalblack,
/area/station/command/heads_quarters/nanotrasen_representative)
"T" = (
/turf/closed/wall/r_wall,
/area/station/command/heads_quarters/blueshield)
"U" = (
/obj/machinery/atmospherics/pipe/smart/manifold4w/scrubbers/hidden/layer2,
/obj/machinery/power/apc/auto_name/directional/east,
/obj/structure/cable,
/turf/open/floor/wood/large,
/area/station/command/heads_quarters/nanotrasen_representative)
"V" = (
/obj/effect/spawner/structure/window/reinforced,
/obj/structure/cable,
/obj/machinery/door/poddoor/shutters/preopen{
	id = "blueshield_privacy";
	name = "Privacy Shutters"
	},
/turf/open/floor/plating,
/area/station/command/heads_quarters/blueshield)
"W" = (
/obj/machinery/status_display/evac/directional/north,
/obj/structure/closet/secure_closet/blueshield,
/obj/effect/turf_decal/siding/wood{
	dir = 5
	},
/obj/structure/sign/nanotrasen/directional/east,
/turf/open/floor/carpet/blue,
/area/station/command/heads_quarters/blueshield)
"X" = (
/obj/machinery/atmospherics/components/unary/vent_scrubber/on/layer2,
/obj/structure/table/wood,
/obj/effect/turf_decal/siding/wood{
	dir = 6
	},
/obj/item/paper_bin{
	pixel_y = 4
	},
/obj/item/pen/fountain{
	pixel_x = -6;
	pixel_y = 6
	},
/obj/item/stamp/nanotrasen_representative{
	pixel_x = 6
	},
/obj/item/reagent_containers/cup/glass/mug/nanotrasen{
	pixel_x = -12
	},
/turf/open/floor/carpet/royalblack,
/area/station/command/heads_quarters/nanotrasen_representative)
"Y" = (
/obj/structure/bed/dogbed,
/mob/living/basic/mouse/hamster/representative,
/turf/open/floor/wood/large,
/area/station/command/heads_quarters/nanotrasen_representative)
"Z" = (
/obj/structure/cable,
/obj/machinery/atmospherics/pipe/smart/manifold4w/supply/hidden/layer4,
/obj/structure/disposalpipe/segment{
	dir = 4
	},
/obj/effect/spawner/structure/window/reinforced,
/obj/machinery/atmospherics/pipe/smart/manifold4w/scrubbers/hidden/layer2,
/obj/machinery/door/poddoor/shutters/preopen{
	id = "ntr_bs_privacy";
	name = "Privacy Shutters"
	},
/turf/open/floor/plating,
/area/station/command/heads_quarters/nanotrasen_representative)

(1,1,1) = {"
R
s
s
s
t
s
s
"}
(2,1,1) = {"
k
s
G
d
x
c
s
"}
(3,1,1) = {"
s
s
w
S
J
N
s
"}
(4,1,1) = {"
s
O
z
b
J
Y
v
"}
(5,1,1) = {"
s
j
l
X
r
U
g
"}
(6,1,1) = {"
T
T
n
n
Z
s
s
"}
(7,1,1) = {"
T
F
Q
o
m
C
p
"}
(8,1,1) = {"
T
L
a
B
K
A
V
"}
(9,1,1) = {"
T
T
q
y
u
E
T
"}
(10,1,1) = {"
e
T
W
I
h
H
T
"}
(11,1,1) = {"
P
T
T
T
T
T
T
"}
