//MAP CONVERTED BY dmm2tgm.py THIS HEADER COMMENT PREVENTS RECONVERSION, DO NOT REMOVE
"ay" = (
/obj/item/clothing/glasses/hud/security/sunglasses/gars{
	pixel_x = 3;
	pixel_y = -2
	},
/obj/item/clothing/glasses/hud/security/sunglasses/gars{
	pixel_x = 3;
	pixel_y = 2
	},
/obj/item/clothing/glasses/hud/security/sunglasses{
	pixel_x = -3;
	pixel_y = -2
	},
/obj/item/clothing/glasses/hud/security/sunglasses{
	pixel_x = -3;
	pixel_y = 2
	},
/obj/structure/rack,
/obj/effect/turf_decal/bot/left,
/turf/open/floor/iron/dark/textured_large,
/area/station/security/armory)
"br" = (
/obj/machinery/door/poddoor{
	id = "armouryaccess";
	name = "Armoury Access"
	},
/obj/effect/turf_decal/stripes/line,
/obj/effect/turf_decal/stripes/line{
	dir = 1
	},
/turf/open/floor/iron/dark/textured,
/area/station/security/armory)
"cv" = (
/obj/machinery/door/poddoor/shuttledock{
	checkdir = 8
	},
/obj/machinery/door/airlock/external,
/obj/effect/mapping_helpers/airlock/access/all/security/general,
/turf/open/floor/plating,
/area/station/security/armory)
"dm" = (
/obj/structure/rack,
/obj/effect/turf_decal/bot/left,
/obj/item/sledgehammer/tactical{
	pixel_y = 3
	},
/obj/item/sledgehammer/tactical{
	pixel_y = -3
	},
/turf/open/floor/iron/dark/textured_large,
/area/station/security/armory)
"dD" = (
/obj/structure/closet/secure_closet{
	name = "contraband locker";
	req_access = list("armory")
	},
/obj/effect/spawner/random/maintenance/three,
/obj/effect/spawner/random/contraband/armory,
/obj/effect/turf_decal/bot,
/obj/item/radio/intercom/directional/east,
/turf/open/floor/iron/dark/textured_large,
/area/station/security/armory)
"ex" = (
/obj/effect/turf_decal/siding/thinplating_new/dark{
	dir = 5
	},
/obj/effect/turf_decal/siding/thinplating_new/dark/corner{
	dir = 8
	},
/obj/effect/turf_decal/trimline/red/filled/corner{
	dir = 8
	},
/obj/effect/turf_decal/trimline/red/corner,
/obj/effect/turf_decal/trimline/red/arrow_cw{
	dir = 1
	},
/obj/machinery/atmospherics/components/unary/vent_pump/on/layer4{
	dir = 8
	},
/turf/open/floor/iron/dark/textured,
/area/station/security/armory)
"fg" = (
/obj/effect/turf_decal/siding/thinplating_new/dark{
	dir = 10
	},
/obj/effect/turf_decal/siding/thinplating_new/dark/corner{
	dir = 4
	},
/obj/effect/turf_decal/trimline/red/filled/corner{
	dir = 4
	},
/obj/effect/turf_decal/trimline/red/corner{
	dir = 1
	},
/obj/effect/turf_decal/trimline/red/arrow_cw,
/obj/machinery/atmospherics/components/unary/vent_scrubber/on/layer2{
	dir = 8
	},
/turf/open/floor/iron/dark/textured,
/area/station/security/armory)
"fi" = (
/obj/effect/turf_decal/siding/thinplating_new/dark,
/obj/effect/turf_decal/siding/thinplating_new/dark{
	dir = 1
	},
/obj/effect/turf_decal/trimline/red/filled/line{
	dir = 1
	},
/obj/effect/turf_decal/trimline/red/corner{
	dir = 8
	},
/obj/effect/turf_decal/trimline/red/corner,
/obj/structure/cable,
/obj/machinery/atmospherics/pipe/smart/manifold4w/scrubbers/hidden/layer2,
/turf/open/floor/iron/dark/textured,
/area/station/security/armory)
"fr" = (
/obj/machinery/airalarm/directional/east,
/obj/effect/turf_decal/stripes/red/line{
	dir = 1
	},
/turf/open/floor/iron/dark/textured_large,
/area/station/security/armory)
"hd" = (
/obj/effect/turf_decal/siding/thinplating_new/dark{
	dir = 8
	},
/obj/effect/turf_decal/siding/thinplating_new/dark/corner{
	dir = 4
	},
/obj/effect/turf_decal/trimline/red/filled/line{
	dir = 8
	},
/obj/effect/turf_decal/trimline/red/corner{
	dir = 4
	},
/obj/structure/railing{
	dir = 8
	},
/turf/open/floor/iron/dark/textured,
/area/station/security/armory)
"hn" = (
/obj/effect/turf_decal/siding/thinplating_new/dark{
	dir = 4
	},
/obj/effect/turf_decal/siding/thinplating_new/dark/corner{
	dir = 1
	},
/obj/effect/turf_decal/trimline/red/filled/line{
	dir = 4
	},
/obj/effect/turf_decal/trimline/red/corner{
	dir = 1
	},
/obj/structure/railing{
	dir = 4
	},
/turf/open/floor/iron/dark/textured,
/area/station/security/armory)
"iq" = (
/obj/machinery/firealarm/directional/east,
/obj/effect/turf_decal/trimline/red/filled/line{
	dir = 6
	},
/obj/effect/turf_decal/siding/thinplating_new/dark{
	dir = 6
	},
/turf/open/floor/iron/dark/textured,
/area/station/security/armory)
"iu" = (
/obj/effect/turf_decal/siding/thinplating_new/dark,
/obj/effect/turf_decal/siding/thinplating_new/dark{
	dir = 1
	},
/obj/effect/turf_decal/trimline/red/filled/line,
/obj/effect/turf_decal/trimline/red/corner{
	dir = 4
	},
/obj/effect/turf_decal/trimline/red/corner{
	dir = 1
	},
/turf/open/floor/iron/dark/textured,
/area/station/security/armory)
"kb" = (
/obj/structure/rack,
/obj/effect/spawner/random/armory/riot_armor,
/obj/effect/spawner/random/armory/riot_helmet,
/obj/effect/spawner/random/armory/riot_shield,
/obj/effect/turf_decal/bot/left,
/turf/open/floor/iron/dark/textured_large,
/area/station/security/armory)
"lb" = (
/obj/item/reagent_containers/cup/bottle/morphine,
/obj/item/storage/box/chemimp{
	pixel_x = 4;
	pixel_y = 3
	},
/obj/item/storage/box/trackimp,
/obj/item/storage/lockbox/loyalty,
/obj/effect/turf_decal/bot,
/obj/item/radio/intercom/directional/west,
/obj/structure/rack,
/turf/open/floor/iron/dark/textured_large,
/area/station/security/armory)
"ld" = (
/obj/effect/turf_decal/siding/thinplating_new/dark/corner{
	dir = 1
	},
/obj/effect/turf_decal/trimline/red/corner{
	dir = 1
	},
/obj/effect/turf_decal/siding/thinplating_new/dark,
/obj/effect/turf_decal/trimline/red/filled/line,
/turf/open/floor/iron/dark/textured,
/area/station/security/armory)
"lJ" = (
/obj/effect/turf_decal/siding/thinplating_new/dark/corner{
	dir = 8
	},
/obj/effect/turf_decal/trimline/red/corner{
	dir = 8
	},
/obj/effect/turf_decal/siding/thinplating_new/dark{
	dir = 1
	},
/obj/effect/turf_decal/trimline/red/filled/line{
	dir = 1
	},
/turf/open/floor/iron/dark/textured,
/area/station/security/armory)
"lM" = (
/obj/effect/turf_decal/siding/thinplating_new/dark{
	dir = 1
	},
/obj/effect/turf_decal/trimline/red,
/obj/effect/turf_decal/trimline/red/corner{
	dir = 4
	},
/obj/effect/turf_decal/trimline/red/corner{
	dir = 1
	},
/obj/machinery/light/floor,
/turf/open/floor/iron/dark/textured,
/area/station/security/armory)
"mv" = (
/obj/structure/cable,
/obj/machinery/atmospherics/pipe/smart/manifold4w/scrubbers/hidden/layer2,
/obj/structure/rack,
/obj/item/storage/box/firingpins,
/obj/item/storage/box/firingpins{
	pixel_x = 3;
	pixel_y = 3
	},
/obj/effect/spawner/random/armory/barrier_grenades,
/turf/open/floor/iron/dark/textured_large,
/area/station/security/armory)
"ni" = (
/obj/docking_port/stationary{
	dwidth = 4;
	height = 5;
	name = "SS13: Gamma Armory";
	shuttle_id = "gamma_home";
	width = 9
	},
/turf/open/space/basic,
/area/space)
"nL" = (
/obj/structure/rack,
/obj/machinery/firealarm/directional/north,
/obj/item/storage/box/flashbangs{
	pixel_x = 3
	},
/obj/item/storage/box/teargas{
	pixel_x = -1;
	pixel_y = -2
	},
/obj/item/gun/grenadelauncher,
/obj/effect/turf_decal/bot/right,
/turf/open/floor/iron/dark/textured_large,
/area/station/security/armory)
"nR" = (
/obj/machinery/camera/autoname/motion/directional/north,
/obj/structure/rack,
/obj/item/vending_refill/security,
/obj/item/storage/box/flashes{
	pixel_x = -2;
	pixel_y = -2
	},
/obj/item/storage/box/handcuffs,
/obj/effect/turf_decal/bot,
/turf/open/floor/iron/dark/textured_large,
/area/station/security/armory)
"oa" = (
/obj/structure/table/reinforced,
/obj/machinery/door/firedoor,
/obj/machinery/door/window/brigdoor/right/directional/north{
	name = "Armoury Desk";
	req_access = list("armory")
	},
/obj/machinery/door/window/right/directional/south{
	name = "Armoury Desk";
	req_access = list("security")
	},
/obj/item/restraints/handcuffs,
/obj/item/assembly/flash/handheld,
/turf/open/floor/iron/dark/textured,
/area/station/security/armory)
"oy" = (
/obj/effect/turf_decal/trimline/red/filled/line,
/obj/effect/turf_decal/siding/thinplating_new/dark,
/turf/open/floor/iron/dark/textured,
/area/station/security/armory)
"qZ" = (
/mob/living/simple_animal/bot/secbot/beepsky/armsky,
/turf/open/floor/glass/reinforced,
/area/station/security/armory)
"rX" = (
/obj/effect/turf_decal/bot,
/obj/structure/secure_safe/directional/east,
/obj/effect/spawner/random/armory/rubbershot,
/obj/structure/rack,
/obj/machinery/camera/autoname/motion/directional/east,
/turf/open/floor/iron/dark/textured_large,
/area/station/security/armory)
"td" = (
/turf/closed/wall/r_wall,
/area/station/security/armory)
"tr" = (
/obj/effect/turf_decal/siding/thinplating_new/dark{
	dir = 9
	},
/obj/effect/turf_decal/siding/thinplating_new/dark/corner,
/obj/effect/turf_decal/trimline/red/filled/corner,
/obj/effect/turf_decal/trimline/red/corner{
	dir = 8
	},
/obj/effect/turf_decal/trimline/red/arrow_ccw{
	dir = 1
	},
/turf/open/floor/iron/dark/textured,
/area/station/security/armory)
"tO" = (
/obj/effect/turf_decal/siding/thinplating_new/dark{
	dir = 1
	},
/obj/effect/turf_decal/trimline/red/filled/line{
	dir = 1
	},
/turf/open/floor/iron/dark/textured,
/area/station/security/armory)
"ux" = (
/obj/effect/turf_decal/bot,
/obj/structure/reagent_dispensers/wall/peppertank/directional/east,
/obj/item/clothing/shoes/jackboots,
/obj/item/clothing/under/rank/centcom/military,
/obj/item/clothing/suit/armor/bulletproof,
/obj/item/clothing/gloves/color/black,
/obj/item/storage/belt/security/webbing,
/obj/item/clothing/head/helmet/toggleable,
/obj/item/knife/combat/survival,
/obj/item/gun/energy/e_gun/mini,
/obj/item/clothing/mask/facescarf,
/obj/item/clothing/mask/gas/sechailer,
/obj/item/clothing/glasses/hud/security/night,
/obj/item/clothing/neck/link_scryer/loaded,
/obj/structure/closet/secure_closet{
	req_access = list("armory");
	name = "Tactical Gear Locker"
	},
/turf/open/floor/iron/dark/textured_large,
/area/station/security/armory)
"uJ" = (
/obj/effect/turf_decal/trimline/red/filled/line{
	dir = 1
	},
/obj/effect/turf_decal/siding/thinplating_new/dark{
	dir = 1
	},
/turf/open/floor/iron/dark/textured,
/area/station/security/armory)
"va" = (
/obj/effect/turf_decal/siding/thinplating_new/dark{
	dir = 9
	},
/obj/effect/turf_decal/trimline/red/filled/line{
	dir = 9
	},
/turf/open/floor/iron/dark/textured,
/area/station/security/armory)
"wX" = (
/obj/structure/rack,
/obj/effect/turf_decal/bot/left,
/obj/machinery/button/door/directional/south{
	id = "armouryaccess";
	name = "Armoury Access";
	req_access = list("armory")
	},
/obj/effect/spawner/random/armory/bulletproof_armor,
/obj/effect/spawner/random/armory/bulletproof_helmet,
/turf/open/floor/iron/dark/textured_large,
/area/station/security/armory)
"xg" = (
/obj/effect/turf_decal/siding/thinplating_new/dark{
	dir = 8
	},
/obj/effect/turf_decal/siding/thinplating_new/dark/corner,
/obj/effect/turf_decal/trimline/red/filled/line{
	dir = 8
	},
/obj/effect/turf_decal/trimline/red/corner,
/obj/structure/railing{
	dir = 8
	},
/turf/open/floor/iron/dark/textured,
/area/station/security/armory)
"xM" = (
/obj/machinery/door/airlock/security/glass{
	name = "Secure Gear Storage"
	},
/obj/effect/turf_decal/stripes/line{
	dir = 1
	},
/obj/effect/turf_decal/stripes/line,
/obj/effect/mapping_helpers/airlock/access/all/security/armory,
/obj/machinery/door/firedoor,
/obj/structure/cable,
/turf/open/floor/iron/dark/textured,
/area/station/security/armory)
"yt" = (
/obj/effect/spawner/structure/window/reinforced,
/obj/structure/cable,
/turf/open/floor/plating,
/area/station/security/armory)
"ze" = (
/obj/effect/turf_decal/siding/thinplating_new/dark{
	dir = 6
	},
/obj/effect/turf_decal/siding/thinplating_new/dark/corner{
	dir = 1
	},
/obj/effect/turf_decal/trimline/red/filled/corner{
	dir = 1
	},
/obj/effect/turf_decal/trimline/red/corner{
	dir = 4
	},
/obj/effect/turf_decal/trimline/red/arrow_ccw,
/obj/structure/cable,
/obj/machinery/atmospherics/pipe/smart/manifold4w/scrubbers/hidden/layer2,
/turf/open/floor/iron/dark/textured,
/area/station/security/armory)
"zo" = (
/obj/structure/rack,
/obj/effect/turf_decal/bot/right,
/obj/item/gun/energy/e_gun/dragnet{
	pixel_y = 4
	},
/obj/item/gun/energy/e_gun/dragnet,
/turf/open/floor/iron/dark/textured_large,
/area/station/security/armory)
"Ab" = (
/obj/effect/turf_decal/siding/thinplating_new/dark,
/obj/effect/turf_decal/trimline/red,
/obj/effect/turf_decal/trimline/red/corner{
	dir = 8
	},
/obj/effect/turf_decal/trimline/red/corner,
/obj/machinery/light/floor,
/obj/structure/cable,
/obj/machinery/holopad/secure,
/turf/open/floor/iron/dark/textured,
/area/station/security/armory)
"Eh" = (
/obj/structure/lattice,
/turf/open/space/basic,
/area/space/nearstation)
"ES" = (
/obj/effect/turf_decal/bot,
/obj/machinery/flasher/portable,
/turf/open/floor/iron/dark/textured_large,
/area/station/security/armory)
"Fg" = (
/obj/structure/rack,
/obj/effect/spawner/random/armory/disablers,
/obj/effect/turf_decal/bot/left,
/obj/machinery/power/apc/auto_name/directional/north,
/obj/structure/cable,
/turf/open/floor/iron/dark/textured_large,
/area/station/security/armory)
"Gb" = (
/obj/effect/turf_decal/siding/thinplating_new/dark,
/obj/effect/turf_decal/siding/thinplating_new/dark{
	dir = 1
	},
/obj/effect/turf_decal/trimline/red/filled/line{
	dir = 1
	},
/obj/effect/turf_decal/trimline/red/corner,
/obj/effect/turf_decal/trimline/red/corner{
	dir = 8
	},
/turf/open/floor/iron/dark/textured,
/area/station/security/armory)
"Gw" = (
/obj/effect/turf_decal/siding/thinplating_new/dark{
	dir = 4
	},
/obj/effect/turf_decal/siding/thinplating_new/dark/corner{
	dir = 8
	},
/obj/effect/turf_decal/trimline/red/filled/line{
	dir = 4
	},
/obj/effect/turf_decal/trimline/red/corner{
	dir = 8
	},
/obj/structure/railing{
	dir = 4
	},
/turf/open/floor/iron/dark/textured,
/area/station/security/armory)
"Gz" = (
/turf/open/floor/glass/reinforced,
/area/station/security/armory)
"Ij" = (
/turf/open/space/basic,
/area/space)
"JY" = (
/obj/effect/turf_decal/siding/thinplating_new/dark{
	dir = 8
	},
/obj/effect/turf_decal/trimline/red,
/obj/effect/turf_decal/trimline/red/corner{
	dir = 1
	},
/obj/effect/turf_decal/trimline/red/corner{
	dir = 8
	},
/obj/machinery/light/floor,
/turf/open/floor/iron/dark/textured,
/area/station/security/armory)
"Ob" = (
/obj/structure/table/reinforced,
/obj/machinery/recharger,
/turf/open/floor/iron/dark/textured_large,
/area/station/security/armory)
"Rm" = (
/obj/effect/turf_decal/bot,
/obj/structure/guncase/ecase{
	open = 0;
	anchored = 1
	},
/obj/item/gun/energy/e_gun,
/obj/item/gun/energy/e_gun,
/obj/item/gun/energy/e_gun,
/obj/item/gun/energy/e_gun,
/turf/open/floor/iron/dark/textured_large,
/area/station/security/armory)
"RA" = (
/obj/structure/rack,
/obj/effect/turf_decal/bot/right,
/obj/machinery/airalarm/directional/north,
/obj/effect/spawner/random/armory/pick_laser_loadout,
/turf/open/floor/iron/dark/textured_large,
/area/station/security/armory)
"Sa" = (
/obj/structure/lattice/catwalk,
/obj/structure/marker_beacon/burgundy,
/turf/open/space/basic,
/area/space/nearstation)
"TD" = (
/obj/structure/hedge,
/obj/effect/landmark/event_spawn,
/turf/open/floor/glass/reinforced,
/area/station/security/armory)
"UT" = (
/obj/structure/guncase/shotgun{
	open = 0;
	anchored = 1
	},
/obj/effect/turf_decal/bot,
/obj/item/gun/ballistic/shotgun/riot,
/obj/item/gun/ballistic/shotgun/riot,
/obj/item/gun/ballistic/shotgun/riot,
/obj/item/gun/ballistic/shotgun/riot,
/turf/open/floor/iron/dark/textured_large,
/area/station/security/armory)
"UY" = (
/obj/effect/turf_decal/siding/thinplating_new/dark{
	dir = 5
	},
/obj/effect/turf_decal/trimline/red/filled/line{
	dir = 5
	},
/turf/open/floor/iron/dark/textured,
/area/station/security/armory)
"WX" = (
/obj/effect/turf_decal/siding/thinplating_new/dark{
	dir = 1
	},
/obj/effect/turf_decal/siding/thinplating_new/dark,
/obj/effect/turf_decal/trimline/red/filled/line,
/obj/effect/turf_decal/trimline/red/corner{
	dir = 1
	},
/obj/effect/turf_decal/trimline/red/corner{
	dir = 4
	},
/obj/machinery/atmospherics/pipe/smart/manifold4w/supply/hidden/layer4,
/turf/open/floor/iron/dark/textured,
/area/station/security/armory)
"XT" = (
/obj/effect/turf_decal/trimline/red/filled/line{
	dir = 10
	},
/obj/effect/turf_decal/siding/thinplating_new/dark{
	dir = 10
	},
/turf/open/floor/iron/dark/textured,
/area/station/security/armory)
"Yu" = (
/obj/machinery/flasher/portable,
/obj/effect/turf_decal/bot,
/turf/open/floor/iron/dark/textured_large,
/area/station/security/armory)
"Zy" = (
/obj/effect/turf_decal/bot,
/obj/machinery/flasher/portable,
/obj/machinery/light/directional/north,
/obj/machinery/newscaster/directional/north,
/turf/open/floor/iron/dark/textured_large,
/area/station/security/armory)

(1,1,1) = {"
Sa
Ij
Ij
Ij
Ij
Ij
td
ES
ES
lb
td
Fg
fi
qZ
WX
wX
td
"}
(2,1,1) = {"
Eh
Ij
Ij
Ij
Ij
Ij
td
Yu
va
XT
yt
xg
ze
Rm
ex
hd
br
"}
(3,1,1) = {"
Eh
Ij
Ij
Ij
Ij
Ij
td
Zy
uJ
oy
xM
Ab
mv
TD
Ob
lM
oa
"}
(4,1,1) = {"
Eh
Ij
Ij
Ij
Ij
Ij
td
nR
tO
oy
yt
Gw
fg
UT
tr
hn
br
"}
(5,1,1) = {"
Eh
Ij
Ij
Ij
Ij
ni
cv
fr
UY
iq
td
RA
Gb
Gz
iu
kb
td
"}
(6,1,1) = {"
Eh
Ij
Ij
Ij
Ij
Ij
td
td
td
td
td
nL
lJ
JY
ld
ay
td
"}
(7,1,1) = {"
Eh
Ij
Ij
Ij
Ij
Ij
Eh
Eh
Eh
Eh
td
zo
ux
rX
dD
dm
td
"}
(8,1,1) = {"
Eh
Ij
Ij
Ij
Ij
Ij
Eh
Ij
Ij
Ij
td
td
td
td
td
td
td
"}
(9,1,1) = {"
Eh
Ij
Ij
Ij
Ij
Ij
Eh
Ij
Ij
Ij
Ij
Ij
Ij
Ij
Ij
Ij
Ij
"}
(10,1,1) = {"
Eh
Eh
Eh
Eh
Eh
Eh
Eh
Ij
Ij
Ij
Ij
Ij
Ij
Ij
Ij
Ij
Ij
"}
(11,1,1) = {"
Sa
Eh
Eh
Eh
Eh
Eh
Sa
Ij
Ij
Ij
Ij
Ij
Ij
Ij
Ij
Ij
Ij
"}
