//MAP CONVERTED BY dmm2tgm.py THIS HEADER COMMENT PREVENTS RECONVERSION, DO NOT REMOVE
"a" = (
/obj/effect/turf_decal/siding/wood,
/obj/effect/turf_decal/siding/wood{
	dir = 1
	},
/obj/structure/chair/office{
	dir = 4
	},
/obj/machinery/newscaster/directional/north,
/obj/effect/decal/cleanable/dirt,
/mob/living/basic/mothroach/wrynroach{
	name = "Жужука"
	},
/turf/open/floor/wood/tile,
/area/station/maintenance/department/bridge)

(1,1,1) = {"
a
"}
