//MAP CONVERTED BY dmm2tgm.py THIS HEADER COMMENT PREVENTS RECONVERSION, DO NOT REMOVE
"a" = (
/obj/effect/turf_decal/tile/red/fourcorners,
/obj/structure/cable,
/turf/open/floor/iron/dark/textured,
/area/station/security/lockers)

(1,1,1) = {"
a
"}
