//MAP CONVERTED BY dmm2tgm.py THIS HEADER COMMENT PREVENTS RECONVERSION, DO NOT REMOVE
"a" = (
/obj/structure/statue/gold/galactic_map,
/turf/open/floor/wood/large,
/area/station/service/library)
"O" = (
/obj/effect/turf_decal/siding/wood/end{
	dir = 1
	},
/turf/open/floor/carpet/red,
/area/station/service/library)
"T" = (
/obj/effect/turf_decal/siding/wood/end,
/turf/open/floor/carpet/red,
/area/station/service/library)

(1,1,1) = {"
T
a
O
"}
