//MAP CONVERTED BY dmm2tgm.py THIS HEADER COMMENT PREVENTS RECONVERSION, DO NOT REMOVE
"at" = (
/turf/closed/wall/r_wall,
/area/space/nearstation)
"bO" = (
/obj/structure/railing{
	dir = 10
	},
/obj/structure/railing{
	dir = 9
	},
/turf/open/floor/glass/reinforced/airless,
/area/space/nearstation)
"ct" = (
/obj/structure/flora/grass/jungle/b/style_random,
/turf/open/misc/asteroid/airless,
/area/space/nearstation)
"cM" = (
/turf/closed/wall/r_wall,
/area/station/ai/upload/chamber)
"cS" = (
/obj/machinery/atmospherics/pipe/smart/manifold4w/supply/hidden/layer4,
/obj/machinery/atmospherics/pipe/smart/manifold4w/scrubbers/hidden/layer2,
/turf/open/floor/iron/dark/small,
/area/station/escapepodbay)
"dc" = (
/obj/structure/flora/rock/pile/style_random,
/obj/structure/flora/grass/jungle/b/style_random,
/obj/effect/decal/cleanable/dirt,
/turf/open/misc/asteroid/airless,
/area/space/nearstation)
"du" = (
/obj/effect/turf_decal/stripes/white/line{
	dir = 1
	},
/obj/effect/turf_decal/siding/thinplating/dark{
	dir = 1
	},
/obj/effect/decal/cleanable/dirt,
/turf/open/floor/engine/hull/reinforced,
/area/space/nearstation)
"dX" = (
/obj/effect/decal/cleanable/dirt,
/obj/effect/turf_decal/stripes/white/line{
	dir = 8
	},
/turf/open/floor/engine/hull/reinforced,
/area/space/nearstation)
"es" = (
/obj/structure/flora/bush/lavendergrass/style_random,
/obj/effect/decal/cleanable/dirt,
/turf/open/misc/asteroid/airless,
/area/space/nearstation)
"ez" = (
/obj/machinery/door/airlock/external,
/obj/effect/mapping_helpers/airlock/cyclelink_helper{
	dir = 1
	},
/obj/effect/mapping_helpers/airlock/autoname,
/obj/effect/mapping_helpers/airlock/access/all/command/general,
/turf/open/floor/plating,
/area/station/escapepodbay)
"fK" = (
/obj/effect/turf_decal/stripes/line,
/obj/machinery/atmospherics/components/unary/vent_pump/on/layer4{
	dir = 1
	},
/obj/structure/sign/poster/official/nanotrasen_logo/directional/south,
/obj/machinery/light/directional/south,
/turf/open/floor/iron/dark/small,
/area/station/escapepodbay)
"fZ" = (
/obj/effect/turf_decal/stripes/white/corner{
	dir = 1
	},
/obj/effect/turf_decal/siding/thinplating/dark/corner{
	dir = 1
	},
/obj/effect/turf_decal/stripes/white/line{
	dir = 9
	},
/turf/open/floor/engine/hull/reinforced,
/area/space/nearstation)
"gb" = (
/turf/closed/wall/r_wall,
/area/station/command/eva)
"iz" = (
/obj/structure/lattice,
/turf/open/space/openspace,
/area/space/nearstation)
"jV" = (
/turf/open/misc/asteroid/airless{
	icon_state = "asteroid12"
	},
/area/space/nearstation)
"ks" = (
/obj/effect/turf_decal/stripes/line{
	dir = 10
	},
/obj/machinery/power/apc/auto_name/directional/south,
/obj/structure/cable,
/obj/item/kirbyplants/random,
/turf/open/floor/iron/dark/small,
/area/station/escapepodbay)
"kH" = (
/obj/structure/railing,
/obj/structure/railing{
	dir = 1
	},
/turf/open/floor/glass/reinforced/airless,
/area/space/nearstation)
"kQ" = (
/obj/structure/flora/grass/jungle/b/style_random,
/obj/effect/decal/cleanable/dirt,
/turf/open/misc/asteroid/airless{
	icon_state = "asteroid10"
	},
/area/space/nearstation)
"ls" = (
/obj/effect/turf_decal/stripes/line{
	dir = 1
	},
/turf/open/floor/iron/dark/small,
/area/station/escapepodbay)
"lt" = (
/obj/effect/turf_decal/siding/wideplating_new/dark{
	dir = 1
	},
/obj/structure/railing{
	dir = 1
	},
/obj/structure/flora/rock/pile/jungle/style_random,
/turf/open/misc/asteroid/airless,
/area/space/nearstation)
"lA" = (
/obj/structure/lattice/catwalk,
/obj/structure/marker_beacon/burgundy,
/turf/open/space/openspace,
/area/space/nearstation)
"mV" = (
/obj/effect/turf_decal/stripes/white/line{
	dir = 9
	},
/obj/effect/turf_decal/siding/thinplating/dark{
	dir = 6
	},
/obj/effect/decal/cleanable/dirt,
/turf/open/floor/engine/hull/reinforced,
/area/space/nearstation)
"na" = (
/obj/machinery/door/poddoor/preopen{
	id = "queue_hop";
	name = "Privacy Shutters"
	},
/obj/effect/spawner/structure/window/reinforced,
/obj/structure/cable,
/turf/open/floor/plating,
/area/station/command/eva)
"oA" = (
/obj/structure/chair/sofa/bench{
	dir = 1
	},
/obj/machinery/light/directional/south,
/turf/open/floor/iron/dark/small,
/area/station/ai/upload/foyer)
"pQ" = (
/obj/effect/turf_decal/stripes/white/line{
	dir = 6
	},
/obj/effect/turf_decal/stripes/white/corner,
/obj/effect/turf_decal/siding/thinplating/dark/corner,
/obj/effect/decal/cleanable/dirt,
/turf/open/floor/engine/hull/reinforced,
/area/space/nearstation)
"qv" = (
/obj/effect/turf_decal/stripes/white/line{
	dir = 8
	},
/obj/effect/turf_decal/stripes/white/line{
	dir = 4
	},
/obj/effect/turf_decal/siding/thinplating/dark{
	dir = 4
	},
/turf/open/floor/engine/hull/reinforced,
/area/space/nearstation)
"qF" = (
/obj/effect/turf_decal/stripes/line{
	dir = 4;
	plane = -3
	},
/turf/open/floor/iron/dark/small,
/area/station/escapepodbay)
"qN" = (
/obj/effect/turf_decal/siding/wideplating_new/dark{
	dir = 9
	},
/obj/structure/railing{
	dir = 9
	},
/obj/structure/flora/bush/lavendergrass/style_random,
/turf/open/misc/asteroid/airless,
/area/space/nearstation)
"qP" = (
/obj/effect/turf_decal/stripes/white/line{
	dir = 4
	},
/obj/effect/turf_decal/siding/thinplating/dark{
	dir = 4
	},
/turf/open/floor/engine/hull/reinforced,
/area/space/nearstation)
"qQ" = (
/obj/effect/turf_decal/siding/wideplating_new/dark/corner{
	dir = 1
	},
/obj/structure/railing/corner{
	dir = 1
	},
/turf/open/floor/engine/hull/reinforced,
/area/space/nearstation)
"rx" = (
/obj/effect/turf_decal/stripes/white/line,
/obj/effect/turf_decal/siding/thinplating/dark,
/obj/effect/turf_decal/stripes/white/line{
	dir = 1
	},
/turf/open/floor/engine/hull/reinforced,
/area/space/nearstation)
"rA" = (
/obj/effect/turf_decal/stripes/white/line,
/obj/effect/turf_decal/siding/thinplating/dark,
/obj/effect/turf_decal/stripes/white/corner{
	dir = 1
	},
/turf/open/floor/engine/hull/reinforced,
/area/space/nearstation)
"rE" = (
/turf/open/floor/iron/dark/small,
/area/station/escapepodbay)
"rF" = (
/obj/structure/flora/rock/pile/jungle/style_random,
/turf/open/floor/glass/reinforced/airless,
/area/space/nearstation)
"rQ" = (
/obj/effect/turf_decal/trimline/dark_blue,
/obj/machinery/atmospherics/components/unary/vent_pump/on/layer4{
	dir = 1
	},
/obj/structure/cable,
/turf/open/floor/iron/dark/small,
/area/station/ai/upload/foyer)
"rY" = (
/obj/structure/flora/rock/style_random,
/turf/open/misc/asteroid/airless,
/area/space/nearstation)
"tJ" = (
/obj/effect/turf_decal/siding/wideplating_new/dark{
	dir = 8
	},
/obj/structure/railing{
	dir = 8
	},
/obj/structure/marker_beacon/burgundy,
/obj/effect/decal/cleanable/dirt,
/turf/open/floor/engine/hull/reinforced,
/area/space/nearstation)
"ub" = (
/obj/effect/turf_decal/stripes/white/line{
	dir = 1
	},
/obj/effect/turf_decal/siding/thinplating/dark{
	dir = 1
	},
/obj/effect/turf_decal/stripes/white/line,
/turf/open/floor/engine/hull/reinforced,
/area/space/nearstation)
"uj" = (
/turf/open/space/openspace,
/area/space)
"ul" = (
/obj/structure/flora/rock/pile/jungle/style_random,
/turf/open/misc/asteroid/airless,
/area/space/nearstation)
"uW" = (
/obj/effect/turf_decal/trimline/dark_red,
/obj/effect/turf_decal/trimline/dark_red/mid_joiner,
/obj/effect/turf_decal/trimline/dark_red/mid_joiner{
	dir = 4
	},
/obj/effect/turf_decal/trimline/dark_red/mid_joiner{
	dir = 1
	},
/obj/effect/turf_decal/trimline/dark_red/mid_joiner{
	dir = 8
	},
/obj/item/clothing/head/cone,
/turf/open/floor/engine/hull/reinforced,
/area/space/nearstation)
"wg" = (
/obj/effect/turf_decal/stripes/line{
	dir = 8
	},
/obj/machinery/atmospherics/pipe/smart/manifold4w/supply/hidden/layer4,
/obj/machinery/atmospherics/pipe/smart/manifold4w/scrubbers/hidden/layer2,
/obj/structure/cable,
/turf/open/floor/iron/dark/small,
/area/station/escapepodbay)
"wE" = (
/obj/machinery/holopad/secure,
/turf/open/floor/iron/dark/small,
/area/station/escapepodbay)
"wN" = (
/obj/effect/turf_decal/siding/dark,
/obj/effect/turf_decal/trimline/dark_blue/filled/line,
/obj/structure/table/reinforced,
/obj/structure/cable,
/obj/machinery/atmospherics/pipe/smart/manifold4w/supply/hidden/layer4,
/obj/machinery/atmospherics/pipe/smart/manifold4w/scrubbers/hidden/layer2,
/turf/open/floor/iron/dark,
/area/station/ai/upload/foyer)
"xQ" = (
/obj/machinery/door/airlock/external,
/obj/effect/mapping_helpers/airlock/cyclelink_helper{
	dir = 8
	},
/obj/effect/mapping_helpers/airlock/autoname,
/obj/effect/mapping_helpers/airlock/access/all/command/general,
/turf/open/floor/plating,
/area/station/escapepodbay)
"yn" = (
/obj/effect/turf_decal/stripes/white/line{
	dir = 9
	},
/obj/effect/turf_decal/stripes/white/corner{
	dir = 1
	},
/obj/effect/turf_decal/siding/thinplating/dark{
	dir = 6
	},
/turf/open/floor/engine/hull/reinforced,
/area/space/nearstation)
"yI" = (
/obj/effect/turf_decal/siding/dark{
	dir = 1
	},
/obj/effect/turf_decal/trimline/dark_blue/filled/line{
	dir = 1
	},
/obj/structure/hedge,
/obj/item/radio/intercom/directional/south{
	name = "Private Channel";
	frequency = 1447;
	broadcasting = 1
	},
/obj/structure/sign/poster/official/state_laws/directional/east,
/turf/open/floor/iron/dark,
/area/station/ai/upload/foyer)
"yM" = (
/obj/structure/flora/rock/pile/jungle/large/style_random,
/turf/open/floor/glass/reinforced/airless,
/area/space/nearstation)
"yP" = (
/obj/effect/landmark/carpspawn,
/turf/open/space/openspace,
/area/space)
"yV" = (
/obj/structure/flora/grass/jungle/b/style_random,
/obj/structure/flora/bush/lavendergrass/style_random,
/obj/effect/decal/cleanable/dirt,
/turf/open/misc/asteroid/airless,
/area/space/nearstation)
"zq" = (
/turf/open/misc/asteroid/airless{
	icon_state = "asteroid5"
	},
/area/space/nearstation)
"zt" = (
/obj/effect/decal/cleanable/dirt,
/obj/structure/flora/grass/jungle/b/style_random,
/obj/structure/flora/bush/lavendergrass/style_random,
/turf/open/misc/asteroid/airless,
/area/space/nearstation)
"zx" = (
/obj/effect/turf_decal/stripes/line{
	dir = 1
	},
/obj/machinery/camera/autoname/directional/north,
/turf/open/floor/iron/dark/small,
/area/station/escapepodbay)
"zS" = (
/turf/open/space/basic,
/area/space)
"Af" = (
/obj/structure/railing{
	dir = 6
	},
/obj/structure/railing{
	dir = 5
	},
/turf/open/floor/glass/reinforced/airless,
/area/space/nearstation)
"AG" = (
/turf/closed/wall/r_wall,
/area/station/ai/upload/foyer)
"Bu" = (
/obj/effect/turf_decal/stripes/line{
	dir = 9
	},
/obj/machinery/airalarm/directional/north,
/obj/item/kirbyplants/random,
/obj/machinery/firealarm/directional/west,
/turf/open/floor/iron/dark/small,
/area/station/escapepodbay)
"BN" = (
/obj/effect/turf_decal/stripes/white/line,
/obj/effect/turf_decal/stripes/white/line{
	dir = 1
	},
/obj/effect/turf_decal/siding/thinplating/dark,
/turf/open/floor/engine/hull/reinforced,
/area/space/nearstation)
"BQ" = (
/obj/effect/turf_decal/stripes/white/line{
	dir = 4
	},
/obj/effect/turf_decal/siding/thinplating/dark{
	dir = 4
	},
/obj/effect/turf_decal/stripes/white/corner{
	dir = 8
	},
/turf/open/floor/engine/hull/reinforced,
/area/space/nearstation)
"Cy" = (
/turf/closed/wall/r_wall,
/area/station/command/bridge)
"CH" = (
/obj/effect/turf_decal/stripes/white/line{
	dir = 10
	},
/obj/effect/turf_decal/siding/thinplating/dark{
	dir = 5
	},
/turf/open/floor/engine/hull/reinforced,
/area/space/nearstation)
"Da" = (
/obj/effect/turf_decal/stripes/white/line,
/obj/effect/turf_decal/stripes/white/line{
	dir = 1
	},
/obj/effect/turf_decal/siding/thinplating/dark,
/obj/structure/flora/rock/pile/jungle/style_random,
/obj/effect/decal/cleanable/dirt,
/turf/open/floor/engine/hull/reinforced,
/area/space/nearstation)
"De" = (
/obj/effect/turf_decal/stripes/white/line{
	dir = 8
	},
/obj/effect/turf_decal/siding/thinplating/dark{
	dir = 8
	},
/obj/effect/decal/cleanable/dirt,
/obj/effect/turf_decal/stripes/white/corner,
/turf/open/floor/engine/hull/reinforced,
/area/space/nearstation)
"Dq" = (
/obj/structure/lattice/catwalk,
/turf/open/space/openspace,
/area/space/nearstation)
"DB" = (
/obj/effect/turf_decal/stripes/line{
	dir = 6
	},
/obj/item/kirbyplants/random,
/turf/open/floor/iron/dark/small,
/area/station/escapepodbay)
"DO" = (
/obj/effect/turf_decal/stripes/white/line,
/obj/effect/turf_decal/siding/thinplating/dark,
/obj/effect/decal/cleanable/dirt,
/obj/effect/turf_decal/stripes/white/line{
	dir = 1
	},
/turf/open/floor/engine/hull/reinforced,
/area/space/nearstation)
"DW" = (
/obj/effect/turf_decal/stripes/line{
	dir = 5
	},
/obj/item/kirbyplants/random,
/turf/open/floor/iron/dark/small,
/area/station/escapepodbay)
"EZ" = (
/turf/closed/wall/r_wall/rust,
/area/space/nearstation)
"Gv" = (
/obj/effect/turf_decal/siding/dark{
	dir = 9
	},
/obj/effect/turf_decal/trimline/dark_blue/filled/line{
	dir = 9
	},
/obj/structure/chair/sofa/bench/right{
	dir = 1
	},
/turf/open/floor/iron/dark,
/area/station/ai/upload/foyer)
"GA" = (
/obj/effect/turf_decal/stripes/white/corner{
	dir = 4
	},
/obj/effect/turf_decal/siding/thinplating/dark/corner{
	dir = 4
	},
/obj/effect/decal/cleanable/dirt,
/obj/effect/turf_decal/stripes/white/line{
	dir = 5
	},
/turf/open/floor/engine/hull/reinforced,
/area/space/nearstation)
"Hh" = (
/obj/structure/cable,
/obj/machinery/computer/security/telescreen/aiupload/directional/north,
/obj/machinery/atmospherics/pipe/smart/manifold4w/supply/hidden/layer4,
/obj/machinery/atmospherics/pipe/smart/manifold4w/scrubbers/hidden/layer2,
/turf/open/floor/iron/dark/small,
/area/station/ai/upload/foyer)
"HM" = (
/obj/machinery/door/airlock/external,
/obj/effect/mapping_helpers/airlock/cyclelink_helper,
/obj/effect/mapping_helpers/airlock/autoname,
/obj/effect/mapping_helpers/airlock/access/all/command/general,
/turf/open/floor/plating,
/area/station/escapepodbay)
"Ii" = (
/obj/structure/cable,
/obj/machinery/atmospherics/pipe/smart/manifold4w/supply/hidden/layer4,
/obj/machinery/atmospherics/pipe/smart/manifold4w/scrubbers/hidden/layer2,
/turf/open/floor/iron/stairs{
	color = "#3d3e42"
	},
/area/station/ai/upload/foyer)
"IE" = (
/obj/effect/turf_decal/stripes/line,
/obj/item/radio/intercom/directional/south{
	name = "Private Channel";
	frequency = 1447;
	broadcasting = 1
	},
/turf/open/floor/iron/dark/small,
/area/station/escapepodbay)
"Jy" = (
/obj/structure/railing{
	dir = 1
	},
/obj/structure/marker_beacon/burgundy,
/obj/structure/lattice/catwalk,
/turf/open/floor/engine/hull/reinforced,
/area/space/nearstation)
"Kg" = (
/obj/machinery/door/airlock/highsecurity{
	name = "AI Upload Access"
	},
/obj/effect/mapping_helpers/airlock/access/all/command/ai_upload,
/obj/structure/cable,
/obj/machinery/atmospherics/pipe/smart/manifold4w/supply/hidden/layer4,
/obj/machinery/atmospherics/pipe/smart/manifold4w/scrubbers/hidden/layer2,
/obj/machinery/door/firedoor,
/turf/open/floor/iron/dark/small,
/area/station/ai/upload/chamber)
"Ky" = (
/turf/template_noop,
/area/template_noop)
"KR" = (
/obj/structure/lattice/catwalk,
/obj/effect/decal/cleanable/dirt,
/obj/structure/sign/nanotrasen/directional/south,
/turf/open/floor/engine/hull/reinforced,
/area/space/nearstation)
"LW" = (
/obj/machinery/door/airlock/highsecurity,
/obj/machinery/door/firedoor,
/obj/effect/mapping_helpers/airlock/access/all/command/ai_upload,
/obj/effect/turf_decal/tile/dark_blue/fourcorners,
/obj/machinery/atmospherics/pipe/smart/manifold4w/supply/hidden/layer4,
/obj/machinery/atmospherics/pipe/smart/manifold4w/scrubbers/hidden/layer2,
/obj/structure/cable,
/obj/effect/mapping_helpers/airlock/autoname,
/turf/open/floor/iron/dark/small,
/area/station/escapepodbay)
"Mv" = (
/obj/machinery/door/airlock/external,
/obj/effect/mapping_helpers/airlock/cyclelink_helper{
	dir = 4
	},
/obj/effect/mapping_helpers/airlock/autoname,
/obj/effect/mapping_helpers/airlock/access/all/command/general,
/turf/open/floor/plating,
/area/station/escapepodbay)
"Nn" = (
/obj/effect/turf_decal/delivery,
/turf/open/floor/plating,
/area/station/escapepodbay)
"NC" = (
/obj/effect/turf_decal/stripes/white/corner{
	dir = 4
	},
/obj/effect/turf_decal/siding/thinplating/dark/corner{
	dir = 4
	},
/obj/effect/turf_decal/stripes/white/line{
	dir = 5
	},
/turf/open/floor/engine/hull/reinforced,
/area/space/nearstation)
"NO" = (
/obj/docking_port/stationary{
	shuttle_id = "argos_home";
	name = "SS13: Fourth Port Bay";
	height = 17;
	width = 12;
	dwidth = 5;
	dir = 4
	},
/turf/open/space/basic,
/area/space)
"Ox" = (
/obj/effect/turf_decal/stripes/white/line{
	dir = 1
	},
/obj/effect/turf_decal/siding/thinplating/dark{
	dir = 1
	},
/obj/effect/decal/cleanable/dirt,
/obj/effect/turf_decal/stripes/white/corner{
	dir = 8
	},
/turf/open/floor/engine/hull/reinforced,
/area/space/nearstation)
"Py" = (
/obj/structure/flora/rock/pile/jungle/style_random,
/obj/structure/flora/grass/jungle/b/style_random,
/turf/open/misc/asteroid/airless,
/area/space/nearstation)
"PG" = (
/obj/effect/turf_decal/stripes/line{
	dir = 1
	},
/obj/machinery/atmospherics/components/unary/vent_scrubber/on/layer2,
/obj/structure/sign/poster/official/nanotrasen_logo/directional/north,
/obj/machinery/light/directional/north,
/turf/open/floor/iron/dark/small,
/area/station/escapepodbay)
"PW" = (
/obj/effect/turf_decal/stripes/white/line{
	dir = 8
	},
/obj/effect/turf_decal/stripes/white/line{
	dir = 4
	},
/obj/effect/turf_decal/siding/thinplating/dark{
	dir = 4
	},
/obj/effect/decal/cleanable/dirt,
/turf/open/floor/engine/hull/reinforced,
/area/space/nearstation)
"QP" = (
/obj/effect/turf_decal/stripes/white/line,
/turf/open/floor/engine/hull/reinforced,
/area/space/nearstation)
"QQ" = (
/turf/open/floor/glass/reinforced/airless,
/area/space/nearstation)
"Rg" = (
/obj/structure/flora/rock/style_random,
/obj/effect/decal/cleanable/dirt,
/turf/open/misc/asteroid/airless,
/area/space/nearstation)
"RF" = (
/obj/machinery/holopad/secure,
/obj/structure/cable,
/turf/open/floor/iron/dark/small,
/area/station/ai/upload/foyer)
"TY" = (
/turf/open/misc/asteroid/airless,
/area/space/nearstation)
"Uq" = (
/obj/effect/turf_decal/stripes/white/line{
	dir = 1
	},
/obj/effect/turf_decal/siding/thinplating/dark{
	dir = 1
	},
/obj/effect/decal/cleanable/dirt,
/obj/effect/turf_decal/stripes/white/line,
/turf/open/floor/engine/hull/reinforced,
/area/space/nearstation)
"Uy" = (
/obj/structure/flora/rock/pile/jungle/style_random,
/obj/effect/decal/cleanable/dirt,
/turf/open/misc/asteroid/airless,
/area/space/nearstation)
"UI" = (
/obj/structure/sign/departments/aiupload/directional/north,
/obj/effect/turf_decal/siding/dark{
	dir = 10
	},
/obj/effect/turf_decal/trimline/dark_blue/filled/line{
	dir = 10
	},
/obj/machinery/atmospherics/pipe/smart/manifold4w/supply/hidden/layer4,
/obj/structure/railing{
	dir = 8
	},
/obj/machinery/camera/autoname/directional/north{
	network = list("aiupload");
	pixel_x = 22
	},
/obj/effect/landmark/start/cyborg,
/obj/machinery/atmospherics/pipe/smart/manifold4w/scrubbers/hidden/layer2,
/turf/open/floor/iron/dark,
/area/station/ai/upload/foyer)
"UO" = (
/obj/effect/turf_decal/stripes/line,
/turf/open/floor/iron/dark/small,
/area/station/escapepodbay)
"UW" = (
/obj/structure/flora/grass/jungle/b/style_random,
/obj/effect/decal/cleanable/dirt,
/turf/open/misc/asteroid/airless,
/area/space/nearstation)
"Wi" = (
/obj/effect/turf_decal/stripes/white/line{
	dir = 6
	},
/obj/effect/turf_decal/siding/thinplating/dark{
	dir = 9
	},
/turf/open/floor/engine/hull/reinforced,
/area/space/nearstation)
"Wt" = (
/obj/structure/flora/grass/jungle/b/style_random,
/obj/structure/flora/bush/lavendergrass/style_random,
/turf/open/misc/asteroid/airless,
/area/space/nearstation)
"Wx" = (
/obj/effect/spawner/structure/window/reinforced/tinted,
/obj/structure/cable,
/turf/open/floor/plating,
/area/station/ai/upload/chamber)
"WR" = (
/obj/effect/turf_decal/stripes/white/corner,
/obj/effect/turf_decal/siding/thinplating/dark/corner,
/obj/effect/turf_decal/stripes/white/line{
	dir = 6
	},
/turf/open/floor/engine/hull/reinforced,
/area/space/nearstation)
"WX" = (
/turf/open/misc/asteroid/airless{
	icon_state = "asteroid1"
	},
/area/space/nearstation)
"Ya" = (
/obj/effect/spawner/structure/window/reinforced,
/turf/open/floor/plating,
/area/station/escapepodbay)
"Yf" = (
/obj/docking_port/stationary{
	dwidth = 2;
	height = 11;
	name = "SS13: Second Port Bay";
	shuttle_id = "specops_home";
	width = 5
	},
/turf/open/space/basic,
/area/space)
"YR" = (
/obj/structure/flora/bush/lavendergrass/style_random,
/obj/effect/decal/cleanable/dirt,
/turf/open/misc/asteroid/airless{
	icon_state = "asteroid7"
	},
/area/space/nearstation)
"Zr" = (
/turf/closed/wall/r_wall,
/area/station/escapepodbay)

(1,1,1) = {"
Ky
Ky
Ky
Kg
Ii
RF
oA
Cy
"}
(2,1,1) = {"
Ky
Ky
Ky
cM
UI
rQ
Gv
Cy
"}
(3,1,1) = {"
Ky
Ky
Ky
Wx
wN
Hh
yI
Cy
"}
(4,1,1) = {"
Ky
Ky
Ky
cM
AG
LW
AG
Cy
"}
(5,1,1) = {"
Ky
Ky
Ky
Zr
Bu
wg
ks
Zr
"}
(6,1,1) = {"
zS
zS
zS
Zr
ls
cS
UO
Zr
"}
(7,1,1) = {"
zS
zS
zS
Ya
ls
cS
UO
Ya
"}
(8,1,1) = {"
zS
zS
zS
Ya
ls
cS
UO
Ya
"}
(9,1,1) = {"
zS
zS
zS
Zr
PG
cS
fK
Zr
"}
(10,1,1) = {"
zS
Ya
Ya
Zr
zx
rE
UO
Zr
"}
(11,1,1) = {"
Yf
HM
Nn
ez
ls
wE
IE
Zr
"}
(12,1,1) = {"
zS
Ya
Ya
Zr
DW
qF
DB
Zr
"}
(13,1,1) = {"
zS
zS
zS
Zr
Zr
Mv
Zr
Zr
"}
(14,1,1) = {"
zS
zS
zS
zS
Ya
Nn
Ya
zS
"}
(15,1,1) = {"
zS
zS
zS
zS
Ya
xQ
Ya
zS
"}
(16,1,1) = {"
zS
zS
zS
zS
zS
NO
zS
zS
"}

(1,1,2) = {"
yM
QQ
Jy
KR
EZ
ct
gb
Ky
"}
(2,1,2) = {"
QQ
QQ
lt
yV
BN
ul
na
Ky
"}
(3,1,2) = {"
rF
qN
qQ
pQ
yn
ct
gb
gb
"}
(4,1,2) = {"
tJ
qQ
uW
Da
dc
TY
ul
gb
"}
(5,1,2) = {"
PW
PW
qv
at
WX
dc
Wt
gb
"}
(6,1,2) = {"
uj
uj
uj
ub
ul
jV
Wt
rx
"}
(7,1,2) = {"
uj
yP
iz
ub
es
bO
Rg
DO
"}
(8,1,2) = {"
uj
uj
iz
Uq
yV
kH
es
DO
"}
(9,1,2) = {"
iz
iz
iz
ub
jV
Af
Py
DO
"}
(10,1,2) = {"
lA
Wi
De
fZ
rY
UW
zq
DO
"}
(11,1,2) = {"
Dq
du
QP
kQ
Uy
zt
dc
rx
"}
(12,1,2) = {"
lA
CH
BQ
GA
es
TY
Uy
rx
"}
(13,1,2) = {"
iz
iz
iz
at
NC
YR
WR
at
"}
(14,1,2) = {"
uj
uj
uj
iz
Ox
dX
rA
iz
"}
(15,1,2) = {"
uj
uj
uj
iz
CH
qP
mV
iz
"}
(16,1,2) = {"
uj
uj
uj
iz
lA
Dq
lA
iz
"}
