//MAP CONVERTED BY dmm2tgm.py THIS HEADER COMMENT PREVENTS RECONVERSION, DO NOT REMOVE
"a" = (
/turf/template_noop,
/area/template_noop)
"r" = (
/obj/structure/bed/medical,
/obj/structure/cable,
/obj/machinery/atmospherics/pipe/smart/manifold4w/supply/hidden/layer4,
/obj/structure/disposalpipe/segment,
/turf/open/floor/iron/white/smooth_large,
/area/station/medical/treatment_center)
"I" = (
/obj/structure/bed/medical{
	dir = 4
	},
/obj/structure/cable,
/obj/machinery/atmospherics/pipe/smart/manifold4w/scrubbers/hidden/layer2,
/obj/machinery/atmospherics/pipe/smart/manifold4w/supply/hidden/layer4,
/turf/open/floor/iron/white/smooth_large,
/area/station/medical/treatment_center)
"N" = (
/obj/structure/cable,
/obj/machinery/atmospherics/pipe/smart/manifold4w/scrubbers/hidden/layer2,
/obj/machinery/atmospherics/pipe/smart/manifold4w/supply/hidden/layer4,
/obj/structure/bed/medical{
	dir = 4
	},
/turf/open/floor/iron/white/smooth_large,
/area/station/medical/treatment_center)
"U" = (
/obj/machinery/atmospherics/pipe/smart/manifold4w/scrubbers/hidden/layer2,
/obj/structure/disposalpipe/segment,
/obj/structure/bed/medical,
/turf/open/floor/iron/white/smooth_large,
/area/station/medical/treatment_center)

(1,1,1) = {"
I
a
N
"}
(2,1,1) = {"
a
a
a
"}
(3,1,1) = {"
U
a
r
"}
