//MAP CONVERTED BY dmm2tgm.py THIS HEADER COMMENT PREVENTS RECONVERSION, DO NOT REMOVE
"a" = (
/obj/machinery/requests_console/directional/north{
	department = "Robotics";
	name = "Robotics Requests Console"
	},
/obj/effect/mapping_helpers/requests_console/assistance,
/obj/effect/mapping_helpers/requests_console/ore_update,
/obj/effect/mapping_helpers/requests_console/information,
/obj/effect/turf_decal/stripes/corner{
	dir = 4
	},
/obj/structure/cable,
/obj/machinery/atmospherics/pipe/smart/manifold4w/supply/hidden/layer4,
/obj/item/mecha_parts/core,
/obj/structure/rack,
/obj/effect/turf_decal/bot_white,
/turf/open/floor/iron/dark,
/area/station/science/robotics/lab)

(1,1,1) = {"
a
"}
