//MAP CONVERTED BY dmm2tgm.py THIS HEADER COMMENT PREVENTS RECONVERSION, DO NOT REMOVE
"a" = (
/obj/structure/cable,
/obj/structure/statue/gold/galactic_map,
/turf/open/floor/iron/dark/small,
/area/station/command/bridge)

(1,1,1) = {"
a
"}
