//MAP CONVERTED BY dmm2tgm.py THIS HEADER COMMENT PREVENTS RECONVERSION, DO NOT REMOVE
"a" = (
/obj/structure/chair/office{
	dir = 4
	},
/obj/effect/mapping_helpers/broken_floor,
/obj/effect/turf_decal/siding/wood{
	dir = 1
	},
/mob/living/basic/mothroach/wrynroach{
	name = "Жужука"
	},
/turf/open/floor/wood,
/area/station/service/library/abandoned)

(1,1,1) = {"
a
"}
