//MAP CONVERTED BY dmm2tgm.py THIS HEADER COMMENT PREVENTS RECONVERSION, DO NOT REMOVE
"a" = (
/obj/effect/landmark/secequipment,
/obj/effect/turf_decal/bot,
/turf/open/floor/iron/showroomfloor,
/area/station/security/lockers)

(1,1,1) = {"
a
"}
